Date & Time,Charleville Mall,Charleville Mall Cyclist IN,Charleville Mall Cyclist OUT,Grove Road Totem,Grove Road Totem OUT,Grove Road Totem IN,Guild Street,Guild Street bikes IN-Towards Quays,Guild Street bikes OUT-Towards Drumcondra,North Strand Rd N/B,North Strand Rd S/B
01-01-2020 00:00:00,0,0,0,12,6,6,5,4,1,13,8
01-01-2020 01:00:00,1,1,0,13,5,8,4,0,4,10,2
01-01-2020 02:00:00,2,1,1,16,12,4,5,1,4,13,6
01-01-2020 03:00:00,3,2,1,15,7,8,2,2,0,13,5
01-01-2020 04:00:00,1,1,0,18,16,2,1,1,0,11,1
01-01-2020 05:00:00,1,0,1,14,9,5,3,2,1,8,2
01-01-2020 06:00:00,0,0,0,19,6,13,9,9,0,8,10
01-01-2020 07:00:00,0,0,0,18,4,14,15,12,3,8,9
01-01-2020 08:00:00,0,0,0,18,7,11,12,11,1,10,11
01-01-2020 09:00:00,1,0,1,26,3,23,10,9,1,6,14
01-01-2020 10:00:00,1,1,0,31,13,18,17,12,5,7,17
01-01-2020 11:00:00,1,0,1,38,11,27,15,11,4,17,24
01-01-2020 12:00:00,0,0,0,51,22,29,14,14,0,20,22
01-01-2020 13:00:00,1,1,0,48,20,28,28,20,8,25,14
01-01-2020 14:00:00,3,2,1,45,11,34,25,15,10,26,32
01-01-2020 15:00:00,1,1,0,48,20,28,21,19,2,22,25
01-01-2020 16:00:00,4,3,1,42,21,21,32,20,12,28,19
01-01-2020 17:00:00,0,0,0,45,23,22,26,18,8,31,18
01-01-2020 18:00:00,1,0,1,49,25,24,16,10,6,21,15
01-01-2020 19:00:00,0,0,0,37,23,14,18,9,9,20,8
01-01-2020 20:00:00,0,0,0,32,20,12,12,6,6,19,12
01-01-2020 21:00:00,1,1,0,37,22,15,8,6,2,17,10
01-01-2020 22:00:00,0,0,0,22,17,5,14,9,5,14,3
01-01-2020 23:00:00,1,1,0,9,6,3,4,1,3,13,5
02-01-2020 00:00:00,0,0,0,12,9,3,1,1,0,4,2
02-01-2020 01:00:00,0,0,0,3,2,1,0,0,0,7,3
02-01-2020 02:00:00,0,0,0,2,2,0,0,0,0,1,1
02-01-2020 03:00:00,0,0,0,4,3,1,2,2,0,3,0
02-01-2020 04:00:00,0,0,0,10,3,7,8,8,0,0,7
02-01-2020 05:00:00,0,0,0,21,1,20,13,11,2,5,15
02-01-2020 06:00:00,6,5,1,87,11,76,60,57,3,10,59
02-01-2020 07:00:00,4,3,1,189,30,159,91,82,9,21,93
02-01-2020 08:00:00,13,13,0,424,47,377,153,142,11,24,185
02-01-2020 09:00:00,6,5,1,199,20,179,72,64,8,19,105
02-01-2020 10:00:00,2,0,2,71,22,49,27,20,7,12,33
02-01-2020 11:00:00,1,0,1,48,17,31,33,25,8,14,34
02-01-2020 12:00:00,4,3,1,56,22,34,29,22,7,19,31
02-01-2020 13:00:00,1,1,0,46,17,29,25,15,10,19,19
02-01-2020 14:00:00,2,0,2,52,29,23,33,17,16,33,21
02-01-2020 15:00:00,0,0,0,66,36,30,36,19,17,42,28
02-01-2020 16:00:00,8,4,4,187,107,80,56,25,31,112,27
02-01-2020 17:00:00,7,4,3,356,268,88,108,40,68,266,34
02-01-2020 18:00:00,4,1,3,215,140,75,48,21,27,142,17
02-01-2020 19:00:00,4,2,2,85,55,30,29,11,18,61,21
02-01-2020 20:00:00,5,5,0,52,32,20,21,6,15,36,15
02-01-2020 21:00:00,1,0,1,35,26,9,10,3,7,36,10
02-01-2020 22:00:00,1,1,0,33,19,14,21,8,13,32,1
02-01-2020 23:00:00,3,1,2,23,17,6,11,3,8,14,5
03-01-2020 00:00:00,2,0,2,16,15,1,3,0,3,11,2
03-01-2020 01:00:00,2,0,2,9,4,5,1,0,1,9,1
03-01-2020 02:00:00,0,0,0,6,3,3,0,0,0,2,0
03-01-2020 03:00:00,0,0,0,4,2,2,2,2,0,3,0
03-01-2020 04:00:00,0,0,0,9,3,6,7,7,0,3,4
03-01-2020 05:00:00,1,1,0,20,2,18,14,13,1,4,18
03-01-2020 06:00:00,5,5,0,76,9,67,53,51,2,8,58
03-01-2020 07:00:00,6,4,2,197,26,171,91,85,6,22,102
03-01-2020 08:00:00,22,20,2,438,40,398,159,150,9,25,255
03-01-2020 09:00:00,7,7,0,229,26,203,89,78,11,22,126
03-01-2020 10:00:00,2,2,0,65,16,49,20,15,5,19,34
03-01-2020 11:00:00,6,5,1,67,20,47,36,34,2,12,30
03-01-2020 12:00:00,6,3,3,74,26,48,43,29,14,35,61
03-01-2020 13:00:00,4,3,1,84,35,49,45,25,20,49,54
03-01-2020 14:00:00,7,5,2,88,37,51,41,23,18,47,43
03-01-2020 15:00:00,3,2,1,120,62,58,37,21,16,75,41
03-01-2020 16:00:00,3,2,1,192,126,66,66,34,32,138,37
03-01-2020 17:00:00,9,3,6,322,247,75,120,41,79,219,43
03-01-2020 18:00:00,2,0,2,208,135,73,69,34,35,160,22
03-01-2020 19:00:00,7,3,4,104,65,39,40,21,19,58,14
03-01-2020 20:00:00,2,1,1,73,49,24,20,6,14,45,10
03-01-2020 21:00:00,5,4,1,40,27,13,18,10,8,40,5
03-01-2020 22:00:00,0,0,0,41,28,13,16,7,9,34,6
03-01-2020 23:00:00,1,1,0,31,26,5,11,2,9,20,6
04-01-2020 00:00:00,0,0,0,25,17,8,9,3,6,13,6
04-01-2020 01:00:00,1,1,0,11,7,4,1,1,0,14,3
04-01-2020 02:00:00,0,0,0,7,7,0,0,0,0,16,2
04-01-2020 03:00:00,2,2,0,6,4,2,0,0,0,6,1
04-01-2020 04:00:00,1,0,1,7,2,5,2,2,0,5,5
04-01-2020 05:00:00,1,0,1,15,3,12,6,6,0,4,9
04-01-2020 06:00:00,0,0,0,33,4,29,16,16,0,6,13
04-01-2020 07:00:00,2,1,1,33,8,25,17,14,3,9,19
04-01-2020 08:00:00,1,1,0,63,13,50,19,19,0,15,26
04-01-2020 09:00:00,1,1,0,62,14,48,26,20,6,12,30
04-01-2020 10:00:00,3,2,1,61,27,34,33,28,5,7,44
04-01-2020 11:00:00,1,1,0,70,19,51,31,22,9,16,29
04-01-2020 12:00:00,6,3,3,85,33,52,45,31,14,25,40
04-01-2020 13:00:00,3,3,0,71,29,42,36,21,15,39,35
04-01-2020 14:00:00,8,5,3,88,32,56,27,21,6,50,41
04-01-2020 15:00:00,4,1,3,86,39,47,23,18,5,32,39
04-01-2020 16:00:00,7,3,4,73,26,47,42,28,14,41,29
04-01-2020 17:00:00,1,0,1,110,50,60,29,20,9,52,17
04-01-2020 18:00:00,5,4,1,78,35,43,29,18,11,49,13
04-01-2020 19:00:00,2,0,2,81,41,40,17,14,3,41,22
04-01-2020 20:00:00,3,2,1,90,31,59,21,7,14,36,28
04-01-2020 21:00:00,2,2,0,26,12,14,10,6,4,26,4
04-01-2020 22:00:00,1,1,0,34,29,5,16,8,8,22,6
04-01-2020 23:00:00,1,1,0,24,20,4,11,4,7,26,9
05-01-2020 00:00:00,0,0,0,24,16,8,10,2,8,16,5
05-01-2020 01:00:00,3,0,3,11,6,5,1,0,1,12,3
05-01-2020 02:00:00,0,0,0,8,6,2,0,0,0,9,0
05-01-2020 03:00:00,1,0,1,6,4,2,3,2,1,7,3
05-01-2020 04:00:00,0,0,0,9,3,6,1,1,0,5,2
05-01-2020 05:00:00,0,0,0,6,3,3,4,4,0,4,7
05-01-2020 06:00:00,0,0,0,24,3,21,11,10,1,5,13
05-01-2020 07:00:00,0,0,0,30,4,26,14,12,2,5,16
05-01-2020 08:00:00,0,0,0,39,10,29,9,9,0,13,14
05-01-2020 09:00:00,1,1,0,35,8,27,22,18,4,13,23
05-01-2020 10:00:00,2,1,1,63,17,46,18,11,7,21,33
05-01-2020 11:00:00,6,6,0,57,12,45,35,26,9,25,36
05-01-2020 12:00:00,6,3,3,95,51,44,32,21,11,44,32
05-01-2020 13:00:00,2,1,1,78,38,40,36,24,12,44,39
05-01-2020 14:00:00,8,4,4,67,35,32,27,19,8,28,23
05-01-2020 15:00:00,2,1,1,86,40,46,41,25,16,38,39
05-01-2020 16:00:00,0,0,0,99,40,59,39,28,11,27,41
05-01-2020 17:00:00,3,2,1,70,29,41,21,11,10,35,22
05-01-2020 18:00:00,3,2,1,51,25,26,21,12,9,29,20
05-01-2020 19:00:00,1,1,0,71,42,29,20,11,9,24,7
05-01-2020 20:00:00,2,1,1,47,23,24,30,14,16,28,5
05-01-2020 21:00:00,2,1,1,32,23,9,16,8,8,16,4
05-01-2020 22:00:00,0,0,0,24,18,6,13,6,7,24,6
05-01-2020 23:00:00,0,0,0,26,19,7,4,1,3,15,2
06-01-2020 00:00:00,1,1,0,9,8,1,0,0,0,9,2
06-01-2020 01:00:00,0,0,0,7,6,1,0,0,0,5,2
06-01-2020 02:00:00,0,0,0,4,4,0,0,0,0,5,3
06-01-2020 03:00:00,0,0,0,3,1,2,3,3,0,3,1
06-01-2020 04:00:00,0,0,0,10,3,7,6,6,0,4,3
06-01-2020 05:00:00,1,1,0,32,3,29,14,13,1,1,29
06-01-2020 06:00:00,6,6,0,131,15,116,120,116,4,11,80
06-01-2020 07:00:00,14,12,2,387,50,337,151,140,11,35,183
06-01-2020 08:00:00,29,26,3,872,87,785,312,287,25,57,364
06-01-2020 09:00:00,17,16,1,263,27,236,133,123,10,19,168
06-01-2020 10:00:00,2,2,0,55,13,42,29,28,1,9,33
06-01-2020 11:00:00,3,1,2,44,13,31,22,20,2,8,29
06-01-2020 12:00:00,1,1,0,78,34,44,31,19,12,31,26
06-01-2020 13:00:00,6,4,2,78,34,44,36,24,12,45,48
06-01-2020 14:00:00,4,4,0,73,39,34,47,23,24,52,31
06-01-2020 15:00:00,5,1,4,112,73,39,48,22,26,44,32
06-01-2020 16:00:00,12,5,7,203,137,66,76,29,47,171,57
06-01-2020 17:00:00,18,9,9,542,432,110,171,62,109,408,61
06-01-2020 18:00:00,8,4,4,446,349,97,107,34,73,360,24
06-01-2020 19:00:00,2,1,1,149,106,43,34,12,22,110,16
06-01-2020 20:00:00,4,4,0,110,78,32,26,10,16,66,5
06-01-2020 21:00:00,3,1,2,59,47,12,12,3,9,43,4
06-01-2020 22:00:00,3,0,3,45,31,14,19,7,12,40,6
06-01-2020 23:00:00,1,0,1,18,17,1,9,1,8,23,4
07-01-2020 00:00:00,2,1,1,7,5,2,3,1,2,12,3
07-01-2020 01:00:00,2,0,2,3,2,1,1,1,0,5,1
07-01-2020 02:00:00,0,0,0,8,4,4,1,0,1,4,1
07-01-2020 03:00:00,0,0,0,4,1,3,2,2,0,3,1
07-01-2020 04:00:00,0,0,0,8,3,5,9,9,0,5,6
07-01-2020 05:00:00,2,1,1,37,5,32,20,19,1,3,25
07-01-2020 06:00:00,11,9,2,134,19,115,109,107,2,12,86
07-01-2020 07:00:00,8,7,1,416,51,365,172,154,18,38,190
07-01-2020 08:00:00,27,24,3,894,87,807,330,309,21,56,404
07-01-2020 09:00:00,18,14,4,343,30,313,154,139,15,20,242
07-01-2020 10:00:00,0,0,0,87,21,66,40,33,7,12,60
07-01-2020 11:00:00,0,0,0,68,24,44,34,30,4,11,37
07-01-2020 12:00:00,0,0,0,81,35,46,38,23,15,45,34
07-01-2020 13:00:00,0,0,0,78,31,47,47,32,15,49,40
07-01-2020 14:00:00,2,2,0,69,35,34,52,35,17,51,34
07-01-2020 15:00:00,3,3,0,113,69,44,44,22,22,62,28
07-01-2020 16:00:00,6,3,3,239,158,81,79,31,48,198,43
07-01-2020 17:00:00,20,6,14,532,434,98,175,49,126,447,62
07-01-2020 18:00:00,6,2,4,437,355,82,146,43,103,354,28
07-01-2020 19:00:00,6,2,4,176,129,47,65,23,42,115,17
07-01-2020 20:00:00,6,5,1,103,66,37,37,15,22,62,13
07-01-2020 21:00:00,1,0,1,83,64,19,15,8,7,53,10
07-01-2020 22:00:00,0,0,0,48,31,17,19,8,11,26,11
07-01-2020 23:00:00,1,0,1,19,14,5,16,6,10,20,3
08-01-2020 00:00:00,1,0,1,13,10,3,2,1,1,9,2
08-01-2020 01:00:00,3,1,2,3,2,1,3,3,0,7,1
08-01-2020 02:00:00,0,0,0,10,8,2,0,0,0,6,1
08-01-2020 03:00:00,0,0,0,6,3,3,3,1,2,4,0
08-01-2020 04:00:00,0,0,0,11,3,8,6,6,0,4,5
08-01-2020 05:00:00,0,0,0,32,6,26,18,17,1,4,24
08-01-2020 06:00:00,4,4,0,149,21,128,119,115,4,11,87
08-01-2020 07:00:00,13,12,1,441,58,383,181,162,19,39,215
08-01-2020 08:00:00,39,34,5,1001,109,892,361,339,22,62,563
08-01-2020 09:00:00,14,11,3,400,45,355,171,149,22,19,226
08-01-2020 10:00:00,1,1,0,102,15,87,32,25,7,20,54
08-01-2020 11:00:00,0,0,0,66,22,44,39,33,6,11,30
08-01-2020 12:00:00,3,2,1,91,37,54,36,21,15,42,45
08-01-2020 13:00:00,1,0,1,108,41,67,58,35,23,48,54
08-01-2020 14:00:00,2,2,0,97,49,48,40,27,13,58,35
08-01-2020 15:00:00,1,1,0,135,85,50,53,25,28,68,53
08-01-2020 16:00:00,4,3,1,262,169,93,80,37,43,179,53
08-01-2020 17:00:00,25,11,14,560,448,112,220,66,154,451,63
08-01-2020 18:00:00,15,5,10,484,386,98,140,46,94,420,29
08-01-2020 19:00:00,6,3,3,206,155,51,40,14,26,159,21
08-01-2020 20:00:00,0,0,0,109,75,34,40,21,19,76,8
08-01-2020 21:00:00,3,3,0,72,52,20,29,4,25,55,12
08-01-2020 22:00:00,1,0,1,51,41,10,16,4,12,35,11
08-01-2020 23:00:00,1,1,0,32,24,8,21,7,14,24,4
09-01-2020 00:00:00,0,0,0,8,6,2,4,3,1,12,0
09-01-2020 01:00:00,0,0,0,2,1,1,0,0,0,5,0
09-01-2020 02:00:00,0,0,0,4,3,1,0,0,0,1,0
09-01-2020 03:00:00,0,0,0,4,1,3,3,2,1,4,1
09-01-2020 04:00:00,0,0,0,13,3,10,8,8,0,5,9
09-01-2020 05:00:00,0,0,0,29,3,26,18,17,1,4,18
09-01-2020 06:00:00,9,8,1,155,17,138,121,119,2,17,85
09-01-2020 07:00:00,13,10,3,399,60,339,165,153,12,37,199
09-01-2020 08:00:00,35,33,2,959,105,854,316,291,25,54,455
09-01-2020 09:00:00,22,19,3,379,36,343,167,147,20,22,251
09-01-2020 10:00:00,2,1,1,99,16,83,40,36,4,14,59
09-01-2020 11:00:00,1,0,1,58,18,40,26,16,10,12,42
09-01-2020 12:00:00,3,2,1,96,42,54,46,30,16,51,50
09-01-2020 13:00:00,4,2,2,88,36,52,34,24,10,38,37
09-01-2020 14:00:00,11,7,4,80,44,36,46,33,13,55,41
09-01-2020 15:00:00,9,7,2,119,85,34,56,29,27,61,35
09-01-2020 16:00:00,9,7,2,229,144,85,81,45,36,177,52
09-01-2020 17:00:00,19,8,11,566,434,132,164,55,109,372,56
09-01-2020 18:00:00,12,3,9,474,379,95,154,44,110,338,48
09-01-2020 19:00:00,5,1,4,188,143,45,57,27,30,146,27
09-01-2020 20:00:00,4,3,1,121,89,32,34,13,21,101,13
09-01-2020 21:00:00,4,3,1,69,48,21,32,14,18,62,12
09-01-2020 22:00:00,3,2,1,72,47,25,22,4,18,39,10
09-01-2020 23:00:00,3,1,2,35,29,6,16,3,13,34,3
10-01-2020 00:00:00,1,0,1,15,11,4,1,0,1,19,2
10-01-2020 01:00:00,0,0,0,11,8,3,0,0,0,6,2
10-01-2020 02:00:00,1,0,1,6,4,2,1,1,0,6,0
10-01-2020 03:00:00,0,0,0,2,1,1,1,1,0,2,1
10-01-2020 04:00:00,2,1,1,14,6,8,2,2,0,10,5
10-01-2020 05:00:00,1,1,0,32,5,27,22,19,3,4,23
10-01-2020 06:00:00,7,7,0,144,16,128,111,109,2,14,71
10-01-2020 07:00:00,8,6,2,339,44,295,150,135,15,28,151
10-01-2020 08:00:00,35,32,3,761,79,682,301,275,26,57,379
10-01-2020 09:00:00,14,12,2,343,30,313,148,131,17,22,177
10-01-2020 10:00:00,1,0,1,89,23,66,28,25,3,29,48
10-01-2020 11:00:00,4,3,1,63,17,46,48,38,10,21,40
10-01-2020 12:00:00,1,1,0,92,42,50,34,25,9,44,63
10-01-2020 13:00:00,4,2,2,118,39,79,44,23,21,74,22
10-01-2020 14:00:00,0,0,0,101,60,41,42,22,20,60,33
10-01-2020 15:00:00,6,5,1,117,74,43,47,23,24,88,33
10-01-2020 16:00:00,6,2,4,252,174,78,74,31,43,149,37
10-01-2020 17:00:00,9,5,4,459,372,87,147,47,100,359,59
10-01-2020 18:00:00,8,4,4,329,262,67,101,46,55,255,31
10-01-2020 19:00:00,2,1,1,144,100,44,50,20,30,96,17
10-01-2020 20:00:00,3,1,2,99,65,34,32,13,19,77,6
10-01-2020 21:00:00,7,4,3,59,40,19,36,11,25,40,7
10-01-2020 22:00:00,4,3,1,59,33,26,21,8,13,29,5
10-01-2020 23:00:00,1,1,0,40,32,8,15,2,13,25,2
11-01-2020 00:00:00,1,1,0,29,22,7,9,2,7,19,4
11-01-2020 01:00:00,0,0,0,23,16,7,3,0,3,12,1
11-01-2020 02:00:00,1,1,0,7,6,1,2,0,2,13,3
11-01-2020 03:00:00,3,0,3,7,6,1,0,0,0,8,0
11-01-2020 04:00:00,0,0,0,10,3,7,2,1,1,6,2
11-01-2020 05:00:00,0,0,0,14,3,11,11,11,0,5,6
11-01-2020 06:00:00,1,0,1,38,14,24,26,25,1,3,20
11-01-2020 07:00:00,0,0,0,47,13,34,37,32,5,14,14
11-01-2020 08:00:00,2,2,0,62,12,50,25,24,1,7,18
11-01-2020 09:00:00,3,3,0,68,16,52,17,13,4,11,27
11-01-2020 10:00:00,3,2,1,43,11,32,20,17,3,13,13
11-01-2020 11:00:00,4,1,3,50,18,32,25,18,7,11,18
11-01-2020 12:00:00,2,0,2,49,19,30,23,18,5,20,15
11-01-2020 13:00:00,3,2,1,55,31,24,12,9,3,23,5
11-01-2020 14:00:00,0,0,0,36,19,17,18,11,7,14,10
11-01-2020 15:00:00,1,0,1,57,22,35,16,11,5,24,10
11-01-2020 16:00:00,2,2,0,54,24,30,26,17,9,19,10
11-01-2020 17:00:00,0,0,0,93,42,51,15,10,5,35,17
11-01-2020 18:00:00,2,2,0,89,34,55,17,8,9,23,14
11-01-2020 19:00:00,1,0,1,56,24,32,14,9,5,19,6
11-01-2020 20:00:00,4,3,1,41,22,19,14,4,10,20,8
11-01-2020 21:00:00,1,1,0,38,21,17,10,8,2,17,6
11-01-2020 22:00:00,1,1,0,31,26,5,12,6,6,16,4
11-01-2020 23:00:00,0,0,0,27,16,11,13,3,10,21,5
12-01-2020 00:00:00,1,1,0,23,13,10,5,2,3,11,4
12-01-2020 01:00:00,0,0,0,16,6,10,2,0,2,3,2
12-01-2020 02:00:00,0,0,0,12,9,3,2,1,1,7,3
12-01-2020 03:00:00,0,0,0,10,2,8,0,0,0,2,0
12-01-2020 04:00:00,0,0,0,5,2,3,0,0,0,2,1
12-01-2020 05:00:00,1,1,0,6,1,5,6,6,0,4,7
12-01-2020 06:00:00,1,0,1,29,9,20,13,13,0,6,15
12-01-2020 07:00:00,0,0,0,35,6,29,18,16,2,12,15
12-01-2020 08:00:00,0,0,0,45,9,36,20,17,3,6,23
12-01-2020 09:00:00,0,0,0,62,16,46,23,15,8,15,22
12-01-2020 10:00:00,3,2,1,74,29,45,24,15,9,21,19
12-01-2020 11:00:00,6,2,4,72,22,50,37,31,6,27,35
12-01-2020 12:00:00,4,4,0,113,49,64,53,38,15,33,42
12-01-2020 13:00:00,3,2,1,113,34,79,40,30,10,36,21
12-01-2020 14:00:00,1,1,0,77,33,44,37,28,9,41,39
12-01-2020 15:00:00,2,1,1,91,37,54,37,22,15,35,35
12-01-2020 16:00:00,1,1,0,82,43,39,29,17,12,28,34
12-01-2020 17:00:00,7,2,5,88,41,47,33,22,11,37,25
12-01-2020 18:00:00,5,3,2,89,50,39,30,17,13,48,13
12-01-2020 19:00:00,3,1,2,66,40,26,26,11,15,34,6
12-01-2020 20:00:00,2,0,2,53,28,25,11,8,3,24,4
12-01-2020 21:00:00,0,0,0,34,17,17,14,8,6,16,7
12-01-2020 22:00:00,2,1,1,34,29,5,11,5,6,20,4
12-01-2020 23:00:00,3,0,3,19,15,4,7,2,5,15,3
13-01-2020 00:00:00,0,0,0,15,11,4,7,5,2,7,2
13-01-2020 01:00:00,0,0,0,1,1,0,1,1,0,4,3
13-01-2020 02:00:00,0,0,0,3,2,1,1,0,1,1,0
13-01-2020 03:00:00,0,0,0,5,1,4,1,1,0,6,0
13-01-2020 04:00:00,0,0,0,6,1,5,6,6,0,3,7
13-01-2020 05:00:00,1,0,1,28,4,24,18,16,2,2,16
13-01-2020 06:00:00,5,5,0,136,14,122,116,112,4,13,67
13-01-2020 07:00:00,15,11,4,364,59,305,152,144,8,28,177
13-01-2020 08:00:00,36,34,2,749,73,676,302,280,22,57,363
13-01-2020 09:00:00,12,12,0,328,41,287,133,121,12,31,183
13-01-2020 10:00:00,5,4,1,61,13,48,25,20,5,13,37
13-01-2020 11:00:00,3,3,0,58,25,33,15,11,4,12,23
13-01-2020 12:00:00,3,1,2,53,32,21,25,22,3,29,20
13-01-2020 13:00:00,3,1,2,40,23,17,24,14,10,17,15
13-01-2020 14:00:00,2,2,0,45,27,18,21,11,10,24,10
13-01-2020 15:00:00,4,3,1,71,42,29,34,16,18,51,22
13-01-2020 16:00:00,11,4,7,195,135,60,69,37,32,133,44
13-01-2020 17:00:00,10,4,6,383,311,72,129,44,85,284,57
13-01-2020 18:00:00,10,1,9,358,305,53,108,39,69,307,28
13-01-2020 19:00:00,2,2,0,127,99,28,38,19,19,80,9
13-01-2020 20:00:00,3,2,1,76,63,13,27,11,16,45,4
13-01-2020 21:00:00,4,3,1,54,43,11,17,9,8,27,9
13-01-2020 22:00:00,3,3,0,42,27,15,21,4,17,27,5
13-01-2020 23:00:00,2,1,1,18,13,5,7,1,6,15,4
14-01-2020 00:00:00,1,1,0,9,6,3,2,1,1,10,0
14-01-2020 01:00:00,0,0,0,3,2,1,1,1,0,1,3
14-01-2020 02:00:00,0,0,0,6,5,1,0,0,0,5,0
14-01-2020 03:00:00,1,0,1,6,1,5,1,1,0,4,1
14-01-2020 04:00:00,0,0,0,7,1,6,7,7,0,3,6
14-01-2020 05:00:00,0,0,0,27,3,24,16,15,1,5,14
14-01-2020 06:00:00,9,9,0,145,22,123,132,130,2,14,70
14-01-2020 07:00:00,15,14,1,395,48,347,162,153,9,24,166
14-01-2020 08:00:00,39,37,2,912,90,822,355,326,29,56,353
14-01-2020 09:00:00,16,14,2,336,33,303,153,138,15,31,217
14-01-2020 10:00:00,2,2,0,62,15,47,33,27,6,11,51
14-01-2020 11:00:00,2,1,1,42,17,25,26,22,4,16,33
14-01-2020 12:00:00,0,0,0,67,23,44,27,17,10,34,40
14-01-2020 13:00:00,4,3,1,92,35,57,33,18,15,36,33
14-01-2020 14:00:00,4,4,0,79,37,42,33,21,12,44,27
14-01-2020 15:00:00,2,1,1,121,65,56,55,26,29,66,34
14-01-2020 16:00:00,12,5,7,230,149,81,93,48,45,189,42
14-01-2020 17:00:00,9,3,6,529,420,109,170,50,120,428,69
14-01-2020 18:00:00,9,3,6,491,396,95,140,45,95,345,23
14-01-2020 19:00:00,9,5,4,186,134,52,68,30,38,133,9
14-01-2020 20:00:00,4,1,3,132,91,41,42,13,29,79,20
14-01-2020 21:00:00,5,2,3,75,57,18,25,9,16,37,8
14-01-2020 22:00:00,3,3,0,63,46,17,27,10,17,41,5
14-01-2020 23:00:00,3,1,2,28,19,9,14,5,9,33,2
15-01-2020 00:00:00,1,1,0,16,11,5,5,2,3,9,5
15-01-2020 01:00:00,0,0,0,3,2,1,2,2,0,3,0
15-01-2020 02:00:00,0,0,0,2,1,1,1,1,0,4,0
15-01-2020 03:00:00,0,0,0,5,1,4,2,2,0,9,0
15-01-2020 04:00:00,0,0,0,10,3,7,8,8,0,6,3
15-01-2020 05:00:00,1,0,1,28,5,23,23,21,2,4,20
15-01-2020 06:00:00,5,5,0,133,22,111,130,126,4,13,65
15-01-2020 07:00:00,11,11,0,425,54,371,188,170,18,31,195
15-01-2020 08:00:00,43,39,4,948,94,854,338,314,24,53,397
15-01-2020 09:00:00,21,19,2,368,31,337,186,164,22,21,219
15-01-2020 10:00:00,2,0,2,93,21,72,42,38,4,7,39
15-01-2020 11:00:00,1,1,0,75,19,56,32,27,5,15,32
15-01-2020 12:00:00,6,4,2,101,33,68,38,28,10,37,39
15-01-2020 13:00:00,4,3,1,112,44,68,40,26,14,57,57
15-01-2020 14:00:00,7,6,1,110,56,54,43,30,13,58,29
15-01-2020 15:00:00,4,2,2,109,63,46,43,20,23,79,37
15-01-2020 16:00:00,5,4,1,243,152,91,103,52,51,175,45
15-01-2020 17:00:00,14,3,11,518,427,91,165,60,105,451,93
15-01-2020 18:00:00,7,4,3,467,364,103,137,35,102,323,38
15-01-2020 19:00:00,4,2,2,178,126,52,70,27,43,123,13
15-01-2020 20:00:00,0,0,0,119,76,43,34,15,19,70,8
15-01-2020 21:00:00,3,1,2,81,59,22,28,9,19,35,8
15-01-2020 22:00:00,2,2,0,67,45,22,22,8,14,38,5
15-01-2020 23:00:00,1,1,0,27,22,5,13,3,10,30,6
16-01-2020 00:00:00,0,0,0,12,8,4,4,0,4,15,1
16-01-2020 01:00:00,0,0,0,4,4,0,1,1,0,9,2
16-01-2020 02:00:00,0,0,0,5,2,3,0,0,0,3,0
16-01-2020 03:00:00,1,0,1,5,1,4,1,1,0,7,0
16-01-2020 04:00:00,0,0,0,7,2,5,8,8,0,3,7
16-01-2020 05:00:00,0,0,0,36,5,31,20,18,2,6,17
16-01-2020 06:00:00,5,5,0,150,24,126,132,128,4,13,80
16-01-2020 07:00:00,10,9,1,418,58,360,165,152,13,30,159
16-01-2020 08:00:00,38,35,3,935,94,841,326,308,18,56,407
16-01-2020 09:00:00,11,8,3,395,51,344,147,130,17,18,226
16-01-2020 10:00:00,1,1,0,104,20,84,26,22,4,14,45
16-01-2020 11:00:00,5,3,2,48,15,33,24,23,1,6,23
16-01-2020 12:00:00,6,6,0,75,35,40,34,23,11,22,22
16-01-2020 13:00:00,3,1,2,85,41,44,33,21,12,31,29
16-01-2020 14:00:00,1,1,0,86,37,49,36,26,10,48,37
16-01-2020 15:00:00,6,2,4,134,68,66,57,27,30,70,33
16-01-2020 16:00:00,11,7,4,234,151,83,86,42,44,151,32
16-01-2020 17:00:00,10,5,5,527,416,111,136,52,84,305,29
16-01-2020 18:00:00,18,8,10,440,330,110,143,33,110,273,29
16-01-2020 19:00:00,3,2,1,199,137,62,57,18,39,155,30
16-01-2020 20:00:00,3,0,3,122,86,36,46,23,23,93,21
16-01-2020 21:00:00,0,0,0,88,58,30,18,6,12,38,4
16-01-2020 22:00:00,0,0,0,65,51,14,32,15,17,33,7
16-01-2020 23:00:00,1,0,1,30,25,5,18,6,12,27,3
17-01-2020 00:00:00,1,0,1,20,14,6,6,0,6,12,4
17-01-2020 01:00:00,1,1,0,11,9,2,3,2,1,8,3
17-01-2020 02:00:00,0,0,0,7,4,3,1,1,0,6,0
17-01-2020 03:00:00,0,0,0,9,5,4,2,1,1,4,0
17-01-2020 04:00:00,1,0,1,9,4,5,4,4,0,4,6
17-01-2020 05:00:00,1,1,0,27,3,24,25,22,3,4,22
17-01-2020 06:00:00,3,3,0,141,17,124,133,130,3,10,63
17-01-2020 07:00:00,9,9,0,337,51,286,153,140,13,32,187
17-01-2020 08:00:00,27,27,0,819,81,738,310,292,18,52,388
17-01-2020 09:00:00,19,18,1,329,35,294,155,128,27,32,206
17-01-2020 10:00:00,5,5,0,89,18,71,44,38,6,14,48
17-01-2020 11:00:00,6,5,1,63,19,44,38,24,14,29,31
17-01-2020 12:00:00,1,0,1,93,41,52,35,19,16,53,38
17-01-2020 13:00:00,6,4,2,136,64,72,54,30,24,68,41
17-01-2020 14:00:00,5,4,1,116,55,61,48,31,17,47,33
17-01-2020 15:00:00,10,5,5,136,75,61,44,19,25,70,44
17-01-2020 16:00:00,11,5,6,288,190,98,88,34,54,136,43
17-01-2020 17:00:00,12,4,8,439,349,90,155,58,97,362,46
17-01-2020 18:00:00,6,3,3,352,269,83,124,42,82,241,35
17-01-2020 19:00:00,6,3,3,156,97,59,55,17,38,114,7
17-01-2020 20:00:00,2,1,1,98,59,39,30,15,15,58,23
17-01-2020 21:00:00,3,1,2,73,44,29,20,4,16,39,7
17-01-2020 22:00:00,2,1,1,39,31,8,17,6,11,33,7
17-01-2020 23:00:00,1,0,1,40,27,13,15,8,7,34,0
18-01-2020 00:00:00,1,1,0,29,21,8,13,3,10,20,4
18-01-2020 01:00:00,1,0,1,21,15,6,1,0,1,18,6
18-01-2020 02:00:00,1,1,0,12,11,1,0,0,0,5,3
18-01-2020 03:00:00,1,0,1,14,9,5,2,1,1,14,0
18-01-2020 04:00:00,0,0,0,6,3,3,3,3,0,7,3
18-01-2020 05:00:00,2,1,1,11,0,11,6,6,0,4,7
18-01-2020 06:00:00,0,0,0,44,8,36,21,21,0,10,27
18-01-2020 07:00:00,1,1,0,46,7,39,44,42,2,14,24
18-01-2020 08:00:00,2,2,0,68,14,54,22,18,4,12,30
18-01-2020 09:00:00,7,5,2,72,14,58,27,21,6,14,37
18-01-2020 10:00:00,2,1,1,70,25,45,28,24,4,16,34
18-01-2020 11:00:00,3,2,1,71,25,46,28,22,6,23,31
18-01-2020 12:00:00,2,0,2,102,38,64,33,19,14,45,30
18-01-2020 13:00:00,7,4,3,80,31,49,51,26,25,38,32
18-01-2020 14:00:00,5,2,3,103,39,64,45,26,19,50,36
18-01-2020 15:00:00,0,0,0,77,37,40,36,23,13,56,44
18-01-2020 16:00:00,6,6,0,94,37,57,38,26,12,44,45
18-01-2020 17:00:00,5,3,2,109,52,57,25,17,8,47,29
18-01-2020 18:00:00,1,1,0,83,47,36,40,27,13,38,22
18-01-2020 19:00:00,2,1,1,61,33,28,22,13,9,40,12
18-01-2020 20:00:00,4,2,2,46,29,17,17,12,5,28,12
18-01-2020 21:00:00,4,3,1,30,18,12,15,5,10,25,8
18-01-2020 22:00:00,4,2,2,39,26,13,13,9,4,19,9
18-01-2020 23:00:00,5,3,2,31,21,10,11,2,9,22,6
19-01-2020 00:00:00,0,0,0,22,17,5,17,5,12,11,4
19-01-2020 01:00:00,0,0,0,22,17,5,4,2,2,16,3
19-01-2020 02:00:00,1,1,0,12,10,2,1,1,0,4,0
19-01-2020 03:00:00,0,0,0,8,6,2,2,1,1,6,0
19-01-2020 04:00:00,0,0,0,5,2,3,1,1,0,3,3
19-01-2020 05:00:00,0,0,0,7,3,4,5,5,0,4,5
19-01-2020 06:00:00,2,1,1,32,6,26,8,8,0,9,12
19-01-2020 07:00:00,0,0,0,23,4,19,16,15,1,8,14
19-01-2020 08:00:00,2,1,1,39,12,27,16,14,2,7,13
19-01-2020 09:00:00,1,1,0,64,23,41,27,19,8,12,27
19-01-2020 10:00:00,0,0,0,57,8,49,29,14,15,35,27
19-01-2020 11:00:00,1,0,1,62,20,42,25,13,12,20,14
19-01-2020 12:00:00,3,1,2,91,46,45,44,28,16,51,36
19-01-2020 13:00:00,3,0,3,69,33,36,43,25,18,33,35
19-01-2020 14:00:00,3,2,1,88,41,47,30,16,14,31,38
19-01-2020 15:00:00,6,3,3,79,32,47,33,18,15,27,38
19-01-2020 16:00:00,3,2,1,78,26,52,37,28,9,25,28
19-01-2020 17:00:00,5,2,3,80,37,43,27,14,13,37,20
19-01-2020 18:00:00,4,3,1,105,40,65,35,19,16,37,11
19-01-2020 19:00:00,3,2,1,57,34,23,17,11,6,32,10
19-01-2020 20:00:00,1,0,1,56,31,25,19,8,11,25,4
19-01-2020 21:00:00,2,1,1,28,22,6,19,10,9,12,1
19-01-2020 22:00:00,3,2,1,35,26,9,14,6,8,11,2
19-01-2020 23:00:00,0,0,0,25,21,4,6,2,4,16,3
20-01-2020 00:00:00,1,0,1,14,10,4,2,0,2,12,1
20-01-2020 01:00:00,0,0,0,4,2,2,2,2,0,6,3
20-01-2020 02:00:00,0,0,0,3,3,0,1,1,0,1,0
20-01-2020 03:00:00,0,0,0,4,0,4,2,2,0,3,0
20-01-2020 04:00:00,0,0,0,8,0,8,6,6,0,3,6
20-01-2020 05:00:00,1,1,0,36,7,29,26,24,2,7,16
20-01-2020 06:00:00,5,5,0,151,24,127,136,132,4,12,104
20-01-2020 07:00:00,11,10,1,385,43,342,180,163,17,40,196
20-01-2020 08:00:00,36,31,5,867,82,785,335,310,25,48,442
20-01-2020 09:00:00,24,12,12,421,63,358,185,167,18,35,254
20-01-2020 10:00:00,5,2,3,83,17,66,41,40,1,12,52
20-01-2020 11:00:00,3,1,2,59,19,40,29,23,6,25,28
20-01-2020 12:00:00,5,3,2,91,28,63,35,27,8,39,39
20-01-2020 13:00:00,5,4,1,129,57,72,43,24,19,58,48
20-01-2020 14:00:00,5,3,2,107,53,54,46,25,21,71,41
20-01-2020 15:00:00,6,3,3,125,76,49,41,22,19,59,26
20-01-2020 16:00:00,12,6,6,238,154,84,78,34,44,195,49
20-01-2020 17:00:00,6,2,4,583,463,120,179,60,119,452,83
20-01-2020 18:00:00,13,6,7,496,391,105,153,49,104,360,48
20-01-2020 19:00:00,4,3,1,209,156,53,81,29,52,134,37
20-01-2020 20:00:00,6,4,2,132,94,38,37,15,22,77,24
20-01-2020 21:00:00,2,1,1,69,44,25,25,11,14,58,11
20-01-2020 22:00:00,0,0,0,41,32,9,12,3,9,42,7
20-01-2020 23:00:00,1,0,1,25,21,4,12,6,6,15,3
21-01-2020 00:00:00,1,0,1,10,7,3,6,1,5,8,1
21-01-2020 01:00:00,1,0,1,2,2,0,1,1,0,6,2
21-01-2020 02:00:00,0,0,0,8,6,2,2,0,2,6,0
21-01-2020 03:00:00,0,0,0,5,2,3,1,1,0,5,1
21-01-2020 04:00:00,0,0,0,7,3,4,5,4,1,4,3
21-01-2020 05:00:00,1,0,1,37,5,32,21,20,1,5,31
21-01-2020 06:00:00,9,8,1,156,27,129,135,130,5,8,70
21-01-2020 07:00:00,15,13,2,479,58,421,187,173,14,40,285
21-01-2020 08:00:00,50,45,5,1052,100,952,383,360,23,65,327
21-01-2020 09:00:00,17,16,1,388,48,340,183,167,16,21,251
21-01-2020 10:00:00,5,1,4,103,25,78,32,29,3,7,54
21-01-2020 11:00:00,2,0,2,83,32,51,28,21,7,16,43
21-01-2020 12:00:00,4,3,1,98,38,60,35,26,9,49,45
21-01-2020 13:00:00,4,4,0,142,64,78,46,29,17,50,41
21-01-2020 14:00:00,8,3,5,99,37,62,30,22,8,58,24
21-01-2020 15:00:00,4,2,2,156,83,73,56,28,28,74,27
21-01-2020 16:00:00,12,7,5,272,187,85,101,44,57,187,43
21-01-2020 17:00:00,10,2,8,560,439,121,165,55,110,493,75
21-01-2020 18:00:00,11,4,7,491,382,109,141,48,93,362,54
21-01-2020 19:00:00,6,5,1,254,180,74,61,20,41,163,16
21-01-2020 20:00:00,9,3,6,145,104,41,46,17,29,87,9
21-01-2020 21:00:00,5,3,2,98,68,30,35,10,25,56,15
21-01-2020 22:00:00,4,2,2,55,37,18,23,9,14,36,9
21-01-2020 23:00:00,5,1,4,30,24,6,14,5,9,32,3
22-01-2020 00:00:00,1,1,0,17,12,5,6,2,4,20,3
22-01-2020 01:00:00,2,0,2,2,2,0,3,0,3,12,1
22-01-2020 02:00:00,0,0,0,7,6,1,0,0,0,7,1
22-01-2020 03:00:00,1,0,1,6,1,5,1,1,0,4,0
22-01-2020 04:00:00,0,0,0,11,2,9,7,6,1,4,7
22-01-2020 05:00:00,0,0,0,39,6,33,18,17,1,3,26
22-01-2020 06:00:00,5,5,0,167,18,149,140,139,1,13,86
22-01-2020 07:00:00,13,11,2,469,77,392,208,190,18,47,238
22-01-2020 08:00:00,50,44,6,1016,97,919,367,345,22,57,432
22-01-2020 09:00:00,10,9,1,385,44,341,164,145,19,32,223
22-01-2020 10:00:00,3,2,1,119,22,97,54,44,10,6,39
22-01-2020 11:00:00,5,5,0,72,26,46,41,35,6,10,26
22-01-2020 12:00:00,2,1,1,108,43,65,37,23,14,44,47
22-01-2020 13:00:00,4,1,3,128,50,78,46,31,15,53,54
22-01-2020 14:00:00,6,4,2,104,61,43,42,27,15,62,39
22-01-2020 15:00:00,5,3,2,135,73,62,52,22,30,86,37
22-01-2020 16:00:00,9,6,3,255,168,87,105,49,56,208,44
22-01-2020 17:00:00,18,8,10,592,484,108,174,66,108,475,70
22-01-2020 18:00:00,6,4,2,557,419,138,145,41,104,355,59
22-01-2020 19:00:00,4,2,2,230,163,67,74,30,44,158,24
22-01-2020 20:00:00,5,4,1,143,99,44,47,12,35,82,2
22-01-2020 21:00:00,4,2,2,82,59,23,32,15,17,76,13
22-01-2020 22:00:00,0,0,0,50,33,17,22,8,14,36,10
22-01-2020 23:00:00,2,1,1,29,22,7,18,6,12,43,6
23-01-2020 00:00:00,0,0,0,16,13,3,4,1,3,17,4
23-01-2020 01:00:00,1,1,0,10,7,3,0,0,0,6,1
23-01-2020 02:00:00,0,0,0,4,2,2,1,0,1,7,0
23-01-2020 03:00:00,3,2,1,6,2,4,2,2,0,8,1
23-01-2020 04:00:00,0,0,0,11,1,10,8,7,1,2,4
23-01-2020 05:00:00,0,0,0,35,6,29,28,25,3,5,31
23-01-2020 06:00:00,5,4,1,148,20,128,152,150,2,12,108
23-01-2020 07:00:00,12,11,1,451,58,393,190,176,14,47,231
23-01-2020 08:00:00,43,38,5,994,87,907,366,340,26,61,348
23-01-2020 09:00:00,19,16,3,373,51,322,191,171,20,34,232
23-01-2020 10:00:00,4,2,2,115,23,92,43,36,7,21,56
23-01-2020 11:00:00,6,6,0,81,28,53,33,23,10,20,38
23-01-2020 12:00:00,4,3,1,85,31,54,52,37,15,47,48
23-01-2020 13:00:00,7,3,4,141,66,75,58,38,20,53,48
23-01-2020 14:00:00,3,2,1,109,56,53,39,20,19,56,29
23-01-2020 15:00:00,5,4,1,150,79,71,48,23,25,72,44
23-01-2020 16:00:00,14,9,5,266,165,101,109,54,55,198,57
23-01-2020 17:00:00,13,6,7,559,439,120,162,64,98,401,79
23-01-2020 18:00:00,12,5,7,509,394,115,134,46,88,340,45
23-01-2020 19:00:00,3,2,1,208,136,72,63,28,35,114,18
23-01-2020 20:00:00,2,1,1,152,105,47,47,17,30,98,22
23-01-2020 21:00:00,4,2,2,91,76,15,31,16,15,81,20
23-01-2020 22:00:00,1,0,1,76,52,24,30,8,22,52,16
23-01-2020 23:00:00,1,1,0,44,35,9,14,2,12,30,12
24-01-2020 00:00:00,0,0,0,26,19,7,7,0,7,17,4
24-01-2020 01:00:00,0,0,0,10,8,2,4,4,0,4,2
24-01-2020 02:00:00,0,0,0,5,2,3,2,2,0,4,2
24-01-2020 03:00:00,3,1,2,6,2,4,1,0,1,5,1
24-01-2020 04:00:00,1,0,1,9,3,6,6,6,0,3,5
24-01-2020 05:00:00,1,1,0,32,6,26,26,25,1,6,30
24-01-2020 06:00:00,7,6,1,140,14,126,149,146,3,14,88
24-01-2020 07:00:00,10,9,1,365,51,314,157,143,14,38,183
24-01-2020 08:00:00,34,33,1,803,71,732,283,262,21,69,398
24-01-2020 09:00:00,13,11,2,339,43,296,156,138,18,31,178
24-01-2020 10:00:00,2,2,0,100,21,79,44,38,6,17,79
24-01-2020 11:00:00,2,2,0,80,28,52,46,35,11,25,42
24-01-2020 12:00:00,5,3,2,104,37,67,50,38,12,52,45
24-01-2020 13:00:00,3,2,1,141,66,75,50,28,22,74,53
24-01-2020 14:00:00,7,5,2,128,75,53,60,35,25,63,36
24-01-2020 15:00:00,3,2,1,165,105,60,48,25,23,77,44
24-01-2020 16:00:00,9,7,2,285,193,92,86,35,51,181,50
24-01-2020 17:00:00,12,5,7,488,369,119,159,59,100,357,42
24-01-2020 18:00:00,9,4,5,335,235,100,103,38,65,215,49
24-01-2020 19:00:00,3,1,2,167,107,60,59,26,33,117,21
24-01-2020 20:00:00,4,2,2,113,63,50,32,16,16,68,23
24-01-2020 21:00:00,4,3,1,78,46,32,38,14,24,51,17
24-01-2020 22:00:00,3,2,1,55,37,18,19,8,11,35,16
24-01-2020 23:00:00,1,0,1,39,30,9,18,3,15,40,6
25-01-2020 00:00:00,2,2,0,26,19,7,10,2,8,18,5
25-01-2020 01:00:00,0,0,0,25,18,7,6,1,5,13,5
25-01-2020 02:00:00,0,0,0,18,13,5,3,2,1,8,2
25-01-2020 03:00:00,1,0,1,5,2,3,2,1,1,6,1
25-01-2020 04:00:00,0,0,0,10,5,5,2,2,0,8,10
25-01-2020 05:00:00,1,1,0,21,8,13,7,7,0,5,7
25-01-2020 06:00:00,0,0,0,41,7,34,26,25,1,6,17
25-01-2020 07:00:00,1,1,0,58,19,39,50,47,3,16,33
25-01-2020 08:00:00,1,1,0,78,20,58,38,33,5,17,36
25-01-2020 09:00:00,1,1,0,92,22,70,31,26,5,14,43
25-01-2020 10:00:00,0,0,0,80,27,53,41,28,13,34,46
25-01-2020 11:00:00,5,3,2,100,37,63,39,29,10,32,31
25-01-2020 12:00:00,3,1,2,93,40,53,41,31,10,49,35
25-01-2020 13:00:00,10,5,5,95,38,57,61,41,20,47,51
25-01-2020 14:00:00,4,3,1,103,43,60,43,21,22,51,53
25-01-2020 15:00:00,6,3,3,97,45,52,48,25,23,44,43
25-01-2020 16:00:00,2,2,0,92,43,49,44,31,13,53,31
25-01-2020 17:00:00,3,3,0,106,49,57,30,19,11,40,23
25-01-2020 18:00:00,4,2,2,96,44,52,37,20,17,45,17
25-01-2020 19:00:00,3,1,2,75,37,38,31,19,12,41,12
25-01-2020 20:00:00,1,1,0,59,27,32,22,15,7,35,12
25-01-2020 21:00:00,5,3,2,49,26,23,23,16,7,24,17
25-01-2020 22:00:00,1,1,0,46,34,12,12,4,8,18,12
25-01-2020 23:00:00,0,0,0,29,18,11,13,4,9,26,7
26-01-2020 00:00:00,1,1,0,24,16,8,11,5,6,13,6
26-01-2020 01:00:00,2,1,1,14,10,4,9,4,5,17,5
26-01-2020 02:00:00,0,0,0,11,6,5,2,1,1,9,2
26-01-2020 03:00:00,0,0,0,5,4,1,2,0,2,7,0
26-01-2020 04:00:00,2,0,2,12,8,4,1,1,0,6,4
26-01-2020 05:00:00,0,0,0,8,3,5,7,7,0,6,5
26-01-2020 06:00:00,1,1,0,29,5,24,14,14,0,11,13
26-01-2020 07:00:00,3,0,3,26,7,19,15,12,3,5,19
26-01-2020 08:00:00,0,0,0,42,12,30,18,18,0,10,18
26-01-2020 09:00:00,2,2,0,66,20,46,17,15,2,14,20
26-01-2020 10:00:00,6,4,2,89,17,72,49,43,6,17,39
26-01-2020 11:00:00,9,6,3,67,26,41,54,43,11,21,36
26-01-2020 12:00:00,3,1,2,90,39,51,44,22,22,39,38
26-01-2020 13:00:00,4,2,2,80,34,46,60,36,24,38,27
26-01-2020 14:00:00,3,2,1,73,35,38,25,16,9,30,12
26-01-2020 15:00:00,4,2,2,93,44,49,25,14,11,25,28
26-01-2020 16:00:00,1,0,1,95,32,63,30,19,11,33,38
26-01-2020 17:00:00,1,1,0,87,40,47,32,21,11,55,26
26-01-2020 18:00:00,0,0,0,71,32,39,37,17,20,27,15
26-01-2020 19:00:00,1,1,0,61,33,28,27,19,8,23,10
26-01-2020 20:00:00,3,2,1,64,37,27,19,9,10,29,4
26-01-2020 21:00:00,3,2,1,38,26,12,12,7,5,16,4
26-01-2020 22:00:00,3,3,0,36,26,10,11,2,9,27,6
26-01-2020 23:00:00,1,1,0,20,17,3,5,2,3,15,6
27-01-2020 00:00:00,2,0,2,8,6,2,2,1,1,3,0
27-01-2020 01:00:00,0,0,0,6,5,1,0,0,0,11,3
27-01-2020 02:00:00,0,0,0,9,6,3,2,0,2,4,0
27-01-2020 03:00:00,0,0,0,7,2,5,1,1,0,4,1
27-01-2020 04:00:00,3,2,1,9,3,6,8,7,1,6,4
27-01-2020 05:00:00,1,1,0,28,3,25,27,26,1,2,19
27-01-2020 06:00:00,5,5,0,150,12,138,130,126,4,11,103
27-01-2020 07:00:00,15,10,5,364,45,319,178,164,14,40,237
27-01-2020 08:00:00,40,37,3,925,85,840,352,327,25,57,434
27-01-2020 09:00:00,13,12,1,381,41,340,176,157,19,28,287
27-01-2020 10:00:00,4,2,2,102,19,83,28,27,1,12,55
27-01-2020 11:00:00,2,2,0,75,24,51,31,21,10,16,34
27-01-2020 12:00:00,0,0,0,113,39,74,42,27,15,37,41
27-01-2020 13:00:00,9,7,2,101,43,58,39,21,18,50,33
27-01-2020 14:00:00,8,5,3,89,43,46,44,29,15,64,33
27-01-2020 15:00:00,5,3,2,131,75,56,37,16,21,68,38
27-01-2020 16:00:00,9,5,4,230,153,77,83,45,38,187,45
27-01-2020 17:00:00,23,9,14,530,425,105,192,64,128,456,62
27-01-2020 18:00:00,7,1,6,459,364,95,139,39,100,355,49
27-01-2020 19:00:00,1,1,0,213,160,53,78,34,44,156,17
27-01-2020 20:00:00,4,3,1,140,110,30,28,16,12,83,5
27-01-2020 21:00:00,4,1,3,94,77,17,38,15,23,61,7
27-01-2020 22:00:00,1,1,0,52,38,14,16,5,11,46,7
27-01-2020 23:00:00,2,0,2,27,26,1,7,4,3,20,3
28-01-2020 00:00:00,0,0,0,9,8,1,5,2,3,10,4
28-01-2020 01:00:00,0,0,0,6,4,2,1,1,0,6,0
28-01-2020 02:00:00,0,0,0,5,3,2,2,1,1,5,2
28-01-2020 03:00:00,0,0,0,3,0,3,0,0,0,2,0
28-01-2020 04:00:00,1,0,1,9,3,6,8,8,0,5,5
28-01-2020 05:00:00,1,1,0,34,7,27,18,15,3,1,22
28-01-2020 06:00:00,6,6,0,171,24,147,137,135,2,13,99
28-01-2020 07:00:00,12,9,3,433,60,373,195,177,18,32,154
28-01-2020 08:00:00,50,44,6,1042,90,952,344,325,19,64,377
28-01-2020 09:00:00,13,11,2,367,44,323,187,168,19,20,267
28-01-2020 10:00:00,3,2,1,88,18,70,27,23,4,17,63
28-01-2020 11:00:00,7,4,3,80,26,54,29,21,8,18,31
28-01-2020 12:00:00,4,4,0,97,34,63,35,26,9,40,36
28-01-2020 13:00:00,4,3,1,123,55,68,33,20,13,56,38
28-01-2020 14:00:00,3,2,1,89,43,46,41,28,13,55,28
28-01-2020 15:00:00,3,2,1,123,84,39,55,26,29,68,31
28-01-2020 16:00:00,9,7,2,234,161,73,94,40,54,196,39
28-01-2020 17:00:00,14,3,11,534,436,98,181,62,119,419,65
28-01-2020 18:00:00,14,5,9,513,407,106,140,37,103,324,27
28-01-2020 19:00:00,6,4,2,250,174,76,84,30,54,159,13
28-01-2020 20:00:00,2,1,1,144,95,49,46,16,30,78,14
28-01-2020 21:00:00,2,1,1,90,70,20,32,19,13,48,6
28-01-2020 22:00:00,1,1,0,69,50,19,28,11,17,36,7
28-01-2020 23:00:00,1,0,1,34,26,8,17,2,15,28,6
29-01-2020 00:00:00,3,1,2,25,19,6,2,1,1,12,3
29-01-2020 01:00:00,0,0,0,6,5,1,1,1,0,6,2
29-01-2020 02:00:00,0,0,0,5,3,2,2,1,1,3,1
29-01-2020 03:00:00,0,0,0,5,1,4,1,1,0,6,0
29-01-2020 04:00:00,0,0,0,9,3,6,4,4,0,10,5
29-01-2020 05:00:00,1,1,0,36,6,30,27,25,2,2,18
29-01-2020 06:00:00,4,2,2,164,19,145,134,131,3,11,69
29-01-2020 07:00:00,13,11,2,412,51,361,187,165,22,39,197
29-01-2020 08:00:00,40,35,5,919,78,841,376,351,25,62,410
29-01-2020 09:00:00,22,18,4,375,42,333,174,150,24,20,188
29-01-2020 10:00:00,3,2,1,118,23,95,40,36,4,14,46
29-01-2020 11:00:00,2,1,1,78,25,53,32,30,2,9,15
29-01-2020 12:00:00,3,3,0,92,32,60,40,31,9,42,28
29-01-2020 13:00:00,6,4,2,118,47,71,48,27,21,42,53
29-01-2020 14:00:00,1,1,0,100,51,49,50,33,17,42,29
29-01-2020 15:00:00,5,4,1,137,67,70,37,13,24,88,35
29-01-2020 16:00:00,9,4,5,273,179,94,92,45,47,182,52
29-01-2020 17:00:00,15,5,10,554,432,122,177,56,121,445,79
29-01-2020 18:00:00,5,1,4,479,378,101,143,47,96,352,35
29-01-2020 19:00:00,4,1,3,245,187,58,68,22,46,139,17
29-01-2020 20:00:00,5,1,4,142,88,54,49,13,36,89,9
29-01-2020 21:00:00,1,1,0,75,46,29,29,12,17,66,2
29-01-2020 22:00:00,0,0,0,68,50,18,25,7,18,48,5
29-01-2020 23:00:00,1,0,1,31,25,6,14,2,12,28,7
30-01-2020 00:00:00,1,1,0,26,19,7,3,1,2,15,5
30-01-2020 01:00:00,0,0,0,7,5,2,0,0,0,10,0
30-01-2020 02:00:00,1,0,1,6,3,3,0,0,0,6,0
30-01-2020 03:00:00,0,0,0,6,2,4,1,1,0,1,0
30-01-2020 04:00:00,0,0,0,10,2,8,6,6,0,1,4
30-01-2020 05:00:00,2,1,1,38,5,33,26,25,1,4,13
30-01-2020 06:00:00,8,6,2,155,22,133,142,138,4,21,104
30-01-2020 07:00:00,10,9,1,429,47,382,193,184,9,30,161
30-01-2020 08:00:00,41,38,3,928,97,831,325,305,20,52,364
30-01-2020 09:00:00,11,10,1,431,66,365,171,159,12,22,242
30-01-2020 10:00:00,2,1,1,132,36,96,40,35,5,22,63
30-01-2020 11:00:00,11,7,4,82,28,54,42,26,16,26,43
30-01-2020 12:00:00,6,3,3,110,41,69,44,35,9,42,56
30-01-2020 13:00:00,9,5,4,107,40,67,61,41,20,53,40
30-01-2020 14:00:00,9,3,6,112,66,46,32,19,13,70,34
30-01-2020 15:00:00,8,5,3,139,81,58,46,22,24,71,36
30-01-2020 16:00:00,9,3,6,258,172,86,82,40,42,180,53
30-01-2020 17:00:00,20,5,15,518,394,124,174,64,110,343,62
30-01-2020 18:00:00,9,4,5,412,324,88,135,42,93,313,50
30-01-2020 19:00:00,6,1,5,196,143,53,66,23,43,142,27
30-01-2020 20:00:00,4,1,3,180,125,55,48,20,28,99,20
30-01-2020 21:00:00,2,1,1,103,86,17,30,8,22,83,16
30-01-2020 22:00:00,3,2,1,73,52,21,22,6,16,51,9
30-01-2020 23:00:00,1,0,1,41,29,12,13,2,11,38,6
31-01-2020 00:00:00,2,2,0,23,16,7,3,0,3,23,2
31-01-2020 01:00:00,0,0,0,14,13,1,3,2,1,6,0
31-01-2020 02:00:00,0,0,0,4,2,2,3,2,1,10,1
31-01-2020 03:00:00,0,0,0,8,4,4,2,2,0,1,1
31-01-2020 04:00:00,0,0,0,14,6,8,5,5,0,7,4
31-01-2020 05:00:00,3,1,2,34,5,29,27,24,3,3,17
31-01-2020 06:00:00,3,2,1,132,14,118,141,132,9,13,84
31-01-2020 07:00:00,9,8,1,326,39,287,159,146,13,25,195
31-01-2020 08:00:00,36,33,3,803,90,713,290,275,15,40,329
31-01-2020 09:00:00,15,10,5,372,63,309,175,158,17,22,210
31-01-2020 10:00:00,2,1,1,113,26,87,33,30,3,17,74
31-01-2020 11:00:00,3,2,1,85,27,58,30,26,4,22,37
31-01-2020 12:00:00,9,6,3,89,26,63,48,30,18,52,42
31-01-2020 13:00:00,4,1,3,151,71,80,46,28,18,58,49
31-01-2020 14:00:00,6,3,3,132,68,64,43,20,23,73,29
31-01-2020 15:00:00,5,2,3,130,79,51,43,24,19,88,31
31-01-2020 16:00:00,6,3,3,246,152,94,84,31,53,162,50
31-01-2020 17:00:00,11,3,8,462,348,114,145,52,93,328,61
31-01-2020 18:00:00,9,3,6,353,250,103,90,28,62,228,25
31-01-2020 19:00:00,4,3,1,171,118,53,55,21,34,116,29
31-01-2020 20:00:00,3,2,1,102,68,34,48,19,29,92,26
31-01-2020 21:00:00,4,4,0,89,54,35,35,12,23,46,19
31-01-2020 22:00:00,6,6,0,56,35,21,38,13,25,41,18
31-01-2020 23:00:00,2,2,0,56,40,16,22,5,17,35,4
01-02-2020 00:00:00,1,1,0,40,27,13,8,3,5,14,8
01-02-2020 01:00:00,1,1,0,17,12,5,5,3,2,6,1
01-02-2020 02:00:00,3,1,2,10,8,2,7,4,3,22,2
01-02-2020 03:00:00,0,0,0,10,7,3,1,0,1,1,3
01-02-2020 04:00:00,4,2,2,11,8,3,3,2,1,5,2
01-02-2020 05:00:00,1,0,1,19,5,14,6,6,0,4,7
01-02-2020 06:00:00,1,1,0,40,10,30,18,17,1,8,10
01-02-2020 07:00:00,1,1,0,46,12,34,28,26,2,10,29
01-02-2020 08:00:00,2,2,0,71,14,57,30,28,2,9,24
01-02-2020 09:00:00,2,2,0,94,22,72,33,23,10,23,30
01-02-2020 10:00:00,2,1,1,78,33,45,31,29,2,16,29
01-02-2020 11:00:00,3,1,2,97,25,72,48,38,10,24,32
01-02-2020 12:00:00,6,2,4,101,41,60,44,22,22,31,31
01-02-2020 13:00:00,4,3,1,96,38,58,50,35,15,40,54
01-02-2020 14:00:00,4,3,1,98,39,59,37,31,6,35,25
01-02-2020 15:00:00,3,1,2,105,40,65,43,29,14,35,26
01-02-2020 16:00:00,8,3,5,86,31,55,32,26,6,48,32
01-02-2020 17:00:00,3,3,0,105,51,54,29,17,12,48,38
01-02-2020 18:00:00,4,3,1,75,38,37,30,16,14,40,23
01-02-2020 19:00:00,3,2,1,95,45,50,23,16,7,38,16
01-02-2020 20:00:00,4,4,0,89,48,41,26,12,14,29,8
01-02-2020 21:00:00,6,2,4,49,32,17,21,8,13,26,11
01-02-2020 22:00:00,1,0,1,46,33,13,16,8,8,28,6
01-02-2020 23:00:00,3,3,0,40,31,9,14,4,10,27,9
02-02-2020 00:00:00,1,1,0,28,19,9,13,3,10,17,7
02-02-2020 01:00:00,1,0,1,16,8,8,8,1,7,10,0
02-02-2020 02:00:00,0,0,0,15,13,2,2,0,2,11,1
02-02-2020 03:00:00,0,0,0,9,8,1,1,0,1,5,0
02-02-2020 04:00:00,1,0,1,7,2,5,3,3,0,3,2
02-02-2020 05:00:00,0,0,0,13,4,9,6,6,0,3,8
02-02-2020 06:00:00,1,0,1,28,4,24,10,9,1,10,13
02-02-2020 07:00:00,2,1,1,39,7,32,21,20,1,14,14
02-02-2020 08:00:00,2,1,1,40,13,27,12,11,1,7,18
02-02-2020 09:00:00,2,2,0,71,20,51,19,17,2,8,24
02-02-2020 10:00:00,1,0,1,69,13,56,26,19,7,11,15
02-02-2020 11:00:00,6,3,3,75,23,52,25,21,4,18,27
02-02-2020 12:00:00,5,2,3,105,32,73,32,24,8,39,20
02-02-2020 13:00:00,5,4,1,111,44,67,50,32,18,39,30
02-02-2020 14:00:00,3,3,0,69,31,38,38,22,16,31,21
02-02-2020 15:00:00,3,1,2,92,47,45,33,17,16,34,31
02-02-2020 16:00:00,2,2,0,86,33,53,27,18,9,27,28
02-02-2020 17:00:00,5,2,3,81,37,44,26,15,11,29,28
02-02-2020 18:00:00,3,3,0,86,54,32,39,21,18,32,29
02-02-2020 19:00:00,1,0,1,61,41,20,29,16,13,34,13
02-02-2020 20:00:00,1,0,1,39,23,16,22,8,14,23,13
02-02-2020 21:00:00,2,1,1,31,23,8,19,10,9,18,6
02-02-2020 22:00:00,1,0,1,24,13,11,11,2,9,15,6
02-02-2020 23:00:00,0,0,0,19,13,6,9,2,7,16,4
03-02-2020 00:00:00,1,1,0,15,13,2,3,1,2,10,0
03-02-2020 01:00:00,0,0,0,6,4,2,1,0,1,5,4
03-02-2020 02:00:00,0,0,0,5,3,2,0,0,0,2,0
03-02-2020 03:00:00,0,0,0,5,0,5,4,4,0,4,0
03-02-2020 04:00:00,0,0,0,5,2,3,5,5,0,5,8
03-02-2020 05:00:00,1,1,0,32,3,29,24,21,3,3,21
03-02-2020 06:00:00,9,7,2,133,23,110,135,131,4,16,100
03-02-2020 07:00:00,11,8,3,400,58,342,167,156,11,30,213
03-02-2020 08:00:00,41,36,5,938,101,837,348,320,28,55,351
03-02-2020 09:00:00,15,14,1,356,43,313,155,141,14,33,236
03-02-2020 10:00:00,3,3,0,80,11,69,44,41,3,7,42
03-02-2020 11:00:00,4,3,1,69,21,48,23,18,5,21,25
03-02-2020 12:00:00,4,2,2,86,31,55,38,22,16,36,25
03-02-2020 13:00:00,2,1,1,99,41,58,43,23,20,64,46
03-02-2020 14:00:00,5,3,2,87,44,43,32,21,11,45,31
03-02-2020 15:00:00,4,1,3,123,69,54,36,20,16,55,40
03-02-2020 16:00:00,10,4,6,219,149,70,89,40,49,173,53
03-02-2020 17:00:00,13,2,11,563,456,107,187,51,136,413,40
03-02-2020 18:00:00,11,5,6,509,402,107,147,39,108,329,27
03-02-2020 19:00:00,3,2,1,222,163,59,55,17,38,135,14
03-02-2020 20:00:00,3,2,1,121,92,29,36,19,17,68,6
03-02-2020 21:00:00,3,3,0,87,63,24,41,16,25,73,9
03-02-2020 22:00:00,1,0,1,41,34,7,12,5,7,28,2
03-02-2020 23:00:00,0,0,0,26,22,4,6,1,5,17,3
04-02-2020 00:00:00,0,0,0,10,8,2,4,2,2,9,2
04-02-2020 01:00:00,0,0,0,4,3,1,2,2,0,6,0
04-02-2020 02:00:00,1,0,1,6,4,2,0,0,0,4,1
04-02-2020 03:00:00,1,0,1,6,4,2,2,2,0,5,0
04-02-2020 04:00:00,0,0,0,6,3,3,5,4,1,5,4
04-02-2020 05:00:00,0,0,0,34,4,30,23,22,1,3,20
04-02-2020 06:00:00,5,5,0,144,18,126,135,132,3,12,102
04-02-2020 07:00:00,15,11,4,447,57,390,214,195,19,34,222
04-02-2020 08:00:00,38,32,6,1068,101,967,329,306,23,68,464
04-02-2020 09:00:00,15,14,1,410,50,360,169,152,17,20,222
04-02-2020 10:00:00,5,3,2,102,24,78,42,36,6,25,58
04-02-2020 11:00:00,8,7,1,80,31,49,33,24,9,27,35
04-02-2020 12:00:00,6,5,1,101,28,73,43,23,20,60,55
04-02-2020 13:00:00,8,7,1,104,48,56,43,26,17,53,43
04-02-2020 14:00:00,5,1,4,110,57,53,38,20,18,58,39
04-02-2020 15:00:00,5,1,4,129,73,56,46,23,23,65,30
04-02-2020 16:00:00,9,4,5,247,168,79,81,37,44,186,60
04-02-2020 17:00:00,19,7,12,586,458,128,188,65,123,398,76
04-02-2020 18:00:00,8,3,5,533,415,118,150,52,98,375,37
04-02-2020 19:00:00,8,3,5,237,171,66,75,34,41,185,7
04-02-2020 20:00:00,4,2,2,133,112,21,43,21,22,84,8
04-02-2020 21:00:00,9,7,2,95,62,33,43,17,26,71,13
04-02-2020 22:00:00,2,1,1,57,39,18,21,5,16,44,6
04-02-2020 23:00:00,1,0,1,26,21,5,13,4,9,33,4
05-02-2020 00:00:00,1,1,0,20,15,5,6,1,5,9,2
05-02-2020 01:00:00,2,0,2,4,2,2,3,1,2,8,0
05-02-2020 02:00:00,0,0,0,7,6,1,1,0,1,6,1
05-02-2020 03:00:00,1,0,1,5,4,1,4,4,0,5,0
05-02-2020 04:00:00,0,0,0,7,1,6,6,5,1,2,6
05-02-2020 05:00:00,1,1,0,35,10,25,24,21,3,3,25
05-02-2020 06:00:00,8,7,1,138,18,120,142,139,3,16,98
05-02-2020 07:00:00,8,8,0,436,60,376,193,178,15,32,214
05-02-2020 08:00:00,43,38,5,1014,88,926,370,347,23,44,422
05-02-2020 09:00:00,17,13,4,414,51,363,180,159,21,39,236
05-02-2020 10:00:00,5,3,2,105,18,87,35,31,4,18,79
05-02-2020 11:00:00,3,2,1,71,28,43,30,25,5,18,40
05-02-2020 12:00:00,3,3,0,92,36,56,43,27,16,46,51
05-02-2020 13:00:00,5,4,1,128,51,77,45,25,20,57,50
05-02-2020 14:00:00,8,4,4,98,41,57,46,26,20,17,26
05-02-2020 15:00:00,5,5,0,130,66,64,42,19,23,93,35
05-02-2020 16:00:00,13,7,6,241,154,87,98,51,47,198,44
05-02-2020 17:00:00,20,11,9,551,444,107,165,59,106,444,101
05-02-2020 18:00:00,14,7,7,472,358,114,147,43,104,387,51
05-02-2020 19:00:00,6,3,3,210,158,52,70,26,44,140,27
05-02-2020 20:00:00,10,6,4,139,98,41,53,23,30,86,7
05-02-2020 21:00:00,5,5,0,109,76,33,41,19,22,74,10
05-02-2020 22:00:00,1,1,0,77,55,22,23,9,14,42,3
05-02-2020 23:00:00,1,0,1,46,32,14,11,1,10,31,5
06-02-2020 00:00:00,0,0,0,16,11,5,5,0,5,19,4
06-02-2020 01:00:00,1,0,1,12,11,1,1,1,0,7,0
06-02-2020 02:00:00,1,1,0,3,2,1,1,1,0,7,0
06-02-2020 03:00:00,0,0,0,9,3,6,2,2,0,3,1
06-02-2020 04:00:00,0,0,0,6,2,4,7,7,0,5,5
06-02-2020 05:00:00,0,0,0,35,4,31,29,27,2,4,21
06-02-2020 06:00:00,10,9,1,139,22,117,150,146,4,14,88
06-02-2020 07:00:00,6,4,2,428,56,372,186,174,12,31,222
06-02-2020 08:00:00,43,36,7,952,92,860,335,307,28,58,374
06-02-2020 09:00:00,17,15,2,405,48,357,166,145,21,18,203
06-02-2020 10:00:00,2,1,1,91,17,74,43,38,5,9,39
06-02-2020 11:00:00,5,3,2,69,18,51,38,32,6,11,33
06-02-2020 12:00:00,5,3,2,107,45,62,43,27,16,43,48
06-02-2020 13:00:00,4,3,1,113,52,61,55,31,24,49,58
06-02-2020 14:00:00,6,3,3,100,49,51,37,29,8,71,46
06-02-2020 15:00:00,6,4,2,136,74,62,43,15,28,70,40
06-02-2020 16:00:00,8,4,4,259,164,95,103,53,50,184,63
06-02-2020 17:00:00,17,5,12,581,453,128,178,62,116,356,85
06-02-2020 18:00:00,10,4,6,441,339,102,104,36,68,316,45
06-02-2020 19:00:00,3,1,2,223,169,54,68,24,44,110,13
06-02-2020 20:00:00,8,1,7,188,137,51,27,14,13,83,12
06-02-2020 21:00:00,5,3,2,113,77,36,41,15,26,69,0
06-02-2020 22:00:00,0,0,0,80,54,26,29,9,20,55,8
06-02-2020 23:00:00,1,1,0,44,34,10,21,5,16,26,9
07-02-2020 00:00:00,1,0,1,23,16,7,7,3,4,22,3
07-02-2020 01:00:00,0,0,0,8,7,1,2,0,2,9,1
07-02-2020 02:00:00,1,0,1,12,8,4,1,1,0,7,1
07-02-2020 03:00:00,1,1,0,4,1,3,6,4,2,8,1
07-02-2020 04:00:00,1,0,1,10,4,6,4,4,0,4,5
07-02-2020 05:00:00,1,1,0,28,3,25,20,19,1,4,22
07-02-2020 06:00:00,6,6,0,136,13,123,140,136,4,20,83
07-02-2020 07:00:00,6,6,0,356,39,317,168,156,12,28,166
07-02-2020 08:00:00,25,22,3,755,65,690,283,258,25,47,413
07-02-2020 09:00:00,17,15,2,354,43,311,142,134,8,24,168
07-02-2020 10:00:00,2,1,1,82,17,65,33,24,9,10,45
07-02-2020 11:00:00,3,2,1,80,27,53,36,30,6,14,36
07-02-2020 12:00:00,4,1,3,117,44,73,51,31,20,47,59
07-02-2020 13:00:00,1,0,1,151,74,77,44,26,18,68,34
07-02-2020 14:00:00,4,1,3,134,75,59,42,20,22,71,26
07-02-2020 15:00:00,7,6,1,154,78,76,40,23,17,70,19
07-02-2020 16:00:00,8,6,2,230,162,68,88,30,58,127,27
07-02-2020 17:00:00,10,3,7,465,370,95,133,46,87,289,38
07-02-2020 18:00:00,8,4,4,323,235,88,99,35,64,171,26
07-02-2020 19:00:00,3,0,3,158,115,43,61,32,29,96,26
07-02-2020 20:00:00,8,4,4,97,65,32,40,24,16,70,15
07-02-2020 21:00:00,3,1,2,88,60,28,21,10,11,45,20
07-02-2020 22:00:00,3,3,0,44,32,12,20,8,12,28,15
07-02-2020 23:00:00,5,2,3,57,37,20,5,2,3,19,7
08-02-2020 00:00:00,1,1,0,28,20,8,15,4,11,15,6
08-02-2020 01:00:00,1,1,0,11,7,4,4,1,3,20,1
08-02-2020 02:00:00,3,2,1,14,12,2,0,0,0,10,1
08-02-2020 03:00:00,0,0,0,10,8,2,2,1,1,8,1
08-02-2020 04:00:00,2,0,2,3,1,2,1,1,0,5,6
08-02-2020 05:00:00,1,1,0,19,4,15,5,5,0,1,7
08-02-2020 06:00:00,0,0,0,49,9,40,23,23,0,4,19
08-02-2020 07:00:00,1,1,0,57,17,40,44,41,3,5,23
08-02-2020 08:00:00,3,3,0,65,15,50,34,31,3,6,45
08-02-2020 09:00:00,1,1,0,86,17,69,40,39,1,24,35
08-02-2020 10:00:00,1,0,1,77,23,54,36,28,8,22,32
08-02-2020 11:00:00,6,3,3,71,22,49,53,39,14,16,29
08-02-2020 12:00:00,4,0,4,94,40,54,35,23,12,42,37
08-02-2020 13:00:00,6,4,2,85,41,44,51,27,24,42,23
08-02-2020 14:00:00,12,6,6,79,44,35,38,19,19,48,27
08-02-2020 15:00:00,2,1,1,56,29,27,28,13,15,32,25
08-02-2020 16:00:00,4,3,1,67,22,45,33,21,12,30,10
08-02-2020 17:00:00,2,1,1,104,38,66,21,12,9,27,10
08-02-2020 18:00:00,7,4,3,78,38,40,19,7,12,37,9
08-02-2020 19:00:00,4,3,1,37,22,15,16,10,6,30,8
08-02-2020 20:00:00,1,0,1,26,13,13,14,7,7,16,4
08-02-2020 21:00:00,1,1,0,32,15,17,12,6,6,6,4
08-02-2020 22:00:00,3,1,2,25,19,6,12,5,7,19,6
08-02-2020 23:00:00,3,0,3,19,14,5,14,3,11,13,4
09-02-2020 00:00:00,0,0,0,18,10,8,7,2,5,10,1
09-02-2020 01:00:00,0,0,0,7,5,2,4,1,3,5,2
09-02-2020 02:00:00,1,1,0,4,4,0,0,0,0,8,1
09-02-2020 03:00:00,0,0,0,5,4,1,0,0,0,7,1
09-02-2020 04:00:00,0,0,0,3,1,2,1,1,0,2,2
09-02-2020 05:00:00,0,0,0,8,1,7,4,4,0,1,3
09-02-2020 06:00:00,0,0,0,15,2,13,10,10,0,4,12
09-02-2020 07:00:00,1,0,1,15,3,12,16,16,0,4,10
09-02-2020 08:00:00,1,1,0,16,1,15,11,11,0,2,8
09-02-2020 09:00:00,0,0,0,18,4,14,11,10,1,2,7
09-02-2020 10:00:00,0,0,0,33,6,27,10,8,2,9,11
09-02-2020 11:00:00,2,2,0,25,9,16,15,13,2,5,11
09-02-2020 12:00:00,3,1,2,37,14,23,17,16,1,7,12
09-02-2020 13:00:00,4,1,3,52,21,31,31,21,10,22,18
09-02-2020 14:00:00,1,1,0,44,26,18,12,6,6,13,6
09-02-2020 15:00:00,3,0,3,38,18,20,25,15,10,12,13
09-02-2020 16:00:00,1,1,0,38,21,17,15,10,5,13,6
09-02-2020 17:00:00,1,1,0,38,21,17,13,7,6,14,3
09-02-2020 18:00:00,0,0,0,26,12,14,22,16,6,13,9
09-02-2020 19:00:00,0,0,0,38,20,18,14,8,6,14,5
09-02-2020 20:00:00,3,2,1,26,14,12,12,5,7,10,0
09-02-2020 21:00:00,1,0,1,23,16,7,18,8,10,14,5
09-02-2020 22:00:00,1,1,0,18,10,8,6,3,3,9,2
09-02-2020 23:00:00,1,1,0,15,12,3,4,0,4,15,3
10-02-2020 00:00:00,0,0,0,5,4,1,1,1,0,2,1
10-02-2020 01:00:00,0,0,0,2,2,0,1,0,1,5,1
10-02-2020 02:00:00,0,0,0,7,7,0,0,0,0,0,3
10-02-2020 03:00:00,0,0,0,6,1,5,4,4,0,3,0
10-02-2020 04:00:00,0,0,0,10,0,10,7,7,0,3,5
10-02-2020 05:00:00,0,0,0,28,6,22,17,17,0,2,13
10-02-2020 06:00:00,5,5,0,114,6,108,129,127,2,10,72
10-02-2020 07:00:00,5,3,2,305,31,274,123,110,13,31,159
10-02-2020 08:00:00,33,24,9,803,72,731,297,277,20,45,372
10-02-2020 09:00:00,12,12,0,304,37,267,155,138,17,17,200
10-02-2020 10:00:00,3,1,2,74,20,54,32,25,7,13,41
10-02-2020 11:00:00,3,2,1,57,22,35,15,14,1,15,19
10-02-2020 12:00:00,1,1,0,75,23,52,31,20,11,37,29
10-02-2020 13:00:00,2,1,1,67,28,39,36,23,13,46,34
10-02-2020 14:00:00,5,3,2,72,34,38,29,21,8,25,10
10-02-2020 15:00:00,5,2,3,103,62,41,22,11,11,45,10
10-02-2020 16:00:00,7,4,3,189,130,59,67,29,38,145,31
10-02-2020 17:00:00,8,2,6,422,349,73,144,58,86,366,57
10-02-2020 18:00:00,9,3,6,396,317,79,114,37,77,280,20
10-02-2020 19:00:00,3,2,1,162,119,43,49,15,34,104,4
10-02-2020 20:00:00,2,1,1,92,69,23,32,11,21,44,9
10-02-2020 21:00:00,0,0,0,47,38,9,20,10,10,53,6
10-02-2020 22:00:00,3,3,0,36,26,10,23,6,17,29,6
10-02-2020 23:00:00,0,0,0,16,13,3,10,4,6,14,1
11-02-2020 00:00:00,0,0,0,12,8,4,3,2,1,9,1
11-02-2020 01:00:00,0,0,0,4,4,0,3,2,1,1,0
11-02-2020 02:00:00,0,0,0,6,5,1,2,2,0,2,0
11-02-2020 03:00:00,0,0,0,4,1,3,2,2,0,5,1
11-02-2020 04:00:00,1,0,1,8,1,7,5,5,0,2,5
11-02-2020 05:00:00,0,0,0,26,5,21,16,13,3,3,18
11-02-2020 06:00:00,5,4,1,121,13,108,137,135,2,9,64
11-02-2020 07:00:00,8,6,2,334,40,294,137,126,11,28,152
11-02-2020 08:00:00,24,19,5,813,98,715,265,247,18,34,289
11-02-2020 09:00:00,15,12,3,359,48,311,142,125,17,14,163
11-02-2020 10:00:00,5,4,1,92,20,72,36,35,1,7,54
11-02-2020 11:00:00,4,3,1,64,22,42,26,20,6,12,27
11-02-2020 12:00:00,5,3,2,77,27,50,24,18,6,26,26
11-02-2020 13:00:00,7,4,3,87,43,44,42,28,14,45,36
11-02-2020 14:00:00,4,2,2,73,35,38,38,26,12,44,24
11-02-2020 15:00:00,4,2,2,95,62,33,22,11,11,38,13
11-02-2020 16:00:00,8,5,3,234,155,79,60,27,33,175,29
11-02-2020 17:00:00,7,2,5,419,316,103,133,47,86,319,59
11-02-2020 18:00:00,9,2,7,381,318,63,107,35,72,175,25
11-02-2020 19:00:00,4,1,3,184,133,51,61,23,38,135,13
11-02-2020 20:00:00,5,3,2,101,63,38,39,12,27,52,6
11-02-2020 21:00:00,5,3,2,70,56,14,36,17,19,40,6
11-02-2020 22:00:00,0,0,0,47,35,12,22,4,18,34,5
11-02-2020 23:00:00,0,0,0,15,14,1,6,1,5,18,3
12-02-2020 00:00:00,0,0,0,16,12,4,5,1,4,7,0
12-02-2020 01:00:00,0,0,0,1,1,0,0,0,0,2,0
12-02-2020 02:00:00,0,0,0,9,8,1,1,0,1,5,1
12-02-2020 03:00:00,0,0,0,3,1,2,2,2,0,4,0
12-02-2020 04:00:00,0,0,0,11,1,10,5,5,0,3,6
12-02-2020 05:00:00,1,0,1,34,4,30,16,15,1,3,17
12-02-2020 06:00:00,3,2,1,128,16,112,127,125,2,13,79
12-02-2020 07:00:00,6,6,0,380,53,327,169,152,17,31,120
12-02-2020 08:00:00,22,19,3,880,99,781,304,285,19,40,346
12-02-2020 09:00:00,20,18,2,377,50,327,150,135,15,15,184
12-02-2020 10:00:00,5,3,2,109,21,88,39,35,4,11,42
12-02-2020 11:00:00,1,1,0,71,25,46,30,28,2,12,31
12-02-2020 12:00:00,4,3,1,105,34,71,42,28,14,51,50
12-02-2020 13:00:00,6,5,1,116,45,71,41,29,12,40,57
12-02-2020 14:00:00,7,2,5,101,49,52,51,31,20,39,39
12-02-2020 15:00:00,3,1,2,122,63,59,37,21,16,60,28
12-02-2020 16:00:00,3,2,1,227,155,72,74,34,40,160,42
12-02-2020 17:00:00,9,5,4,506,405,101,156,51,105,345,81
12-02-2020 18:00:00,8,3,5,420,337,83,139,40,99,294,43
12-02-2020 19:00:00,5,3,2,198,144,54,61,28,33,135,26
12-02-2020 20:00:00,4,3,1,129,89,40,61,20,41,59,2
12-02-2020 21:00:00,2,1,1,73,52,21,41,13,28,60,6
12-02-2020 22:00:00,6,1,5,60,48,12,18,7,11,38,3
12-02-2020 23:00:00,0,0,0,27,23,4,16,2,14,15,5
13-02-2020 00:00:00,2,2,0,11,8,3,3,1,2,7,3
13-02-2020 01:00:00,0,0,0,4,2,2,2,0,2,6,0
13-02-2020 02:00:00,0,0,0,7,4,3,1,0,1,2,0
13-02-2020 03:00:00,1,0,1,6,3,3,1,1,0,3,0
13-02-2020 04:00:00,0,0,0,7,2,5,8,8,0,0,3
13-02-2020 05:00:00,1,0,1,30,7,23,17,16,1,1,11
13-02-2020 06:00:00,5,4,1,140,16,124,132,130,2,11,76
13-02-2020 07:00:00,10,7,3,360,44,316,159,147,12,32,149
13-02-2020 08:00:00,32,29,3,942,104,838,305,288,17,46,292
13-02-2020 09:00:00,6,6,0,371,52,319,161,138,23,30,217
13-02-2020 10:00:00,3,1,2,99,26,73,37,31,6,11,64
13-02-2020 11:00:00,1,1,0,75,22,53,32,22,10,21,45
13-02-2020 12:00:00,6,4,2,77,31,46,44,31,13,38,51
13-02-2020 13:00:00,8,5,3,99,34,65,39,33,6,50,34
13-02-2020 14:00:00,5,2,3,103,48,55,52,34,18,56,28
13-02-2020 15:00:00,5,5,0,114,64,50,33,15,18,73,41
13-02-2020 16:00:00,10,7,3,241,153,88,81,38,43,154,43
13-02-2020 17:00:00,14,2,12,521,397,124,176,59,117,342,75
13-02-2020 18:00:00,10,4,6,468,359,109,113,38,75,251,33
13-02-2020 19:00:00,4,3,1,235,165,70,69,25,44,125,17
13-02-2020 20:00:00,5,2,3,140,92,48,45,22,23,93,14
13-02-2020 21:00:00,3,1,2,98,67,31,36,16,20,86,8
13-02-2020 22:00:00,0,0,0,70,49,21,18,2,16,53,10
13-02-2020 23:00:00,3,2,1,30,25,5,21,3,18,38,1
14-02-2020 00:00:00,4,2,2,18,16,2,4,2,2,15,3
14-02-2020 01:00:00,1,0,1,5,4,1,5,0,5,8,2
14-02-2020 02:00:00,1,1,0,9,7,2,3,1,2,5,0
14-02-2020 03:00:00,0,0,0,4,1,3,3,2,1,5,3
14-02-2020 04:00:00,0,0,0,19,8,11,4,4,0,6,4
14-02-2020 05:00:00,1,1,0,26,4,22,19,18,1,4,19
14-02-2020 06:00:00,6,5,1,123,12,111,126,121,5,14,66
14-02-2020 07:00:00,11,10,1,345,35,310,136,123,13,27,137
14-02-2020 08:00:00,27,22,5,738,71,667,290,262,28,45,311
14-02-2020 09:00:00,14,11,3,306,33,273,135,119,16,17,182
14-02-2020 10:00:00,4,2,2,75,18,57,37,32,5,12,48
14-02-2020 11:00:00,4,3,1,71,31,40,32,26,6,14,26
14-02-2020 12:00:00,3,3,0,87,33,54,41,22,19,48,43
14-02-2020 13:00:00,4,3,1,110,59,51,48,29,19,70,38
14-02-2020 14:00:00,6,6,0,129,66,63,44,27,17,45,25
14-02-2020 15:00:00,3,3,0,155,96,59,52,28,24,66,28
14-02-2020 16:00:00,12,5,7,243,162,81,88,36,52,137,37
14-02-2020 17:00:00,9,4,5,493,380,113,159,57,102,276,54
14-02-2020 18:00:00,5,3,2,336,243,93,80,23,57,208,34
14-02-2020 19:00:00,5,3,2,174,115,59,50,17,33,92,17
14-02-2020 20:00:00,5,4,1,105,64,41,39,28,11,61,9
14-02-2020 21:00:00,1,1,0,52,33,19,25,6,19,51,10
14-02-2020 22:00:00,1,0,1,47,36,11,16,6,10,26,8
14-02-2020 23:00:00,1,1,0,43,29,14,15,3,12,22,5
15-02-2020 00:00:00,0,0,0,26,21,5,8,0,8,16,9
15-02-2020 01:00:00,4,2,2,15,13,2,4,0,4,14,4
15-02-2020 02:00:00,0,0,0,8,7,1,4,0,4,9,3
15-02-2020 03:00:00,0,0,0,8,7,1,1,0,1,6,0
15-02-2020 04:00:00,0,0,0,7,4,3,6,5,1,6,4
15-02-2020 05:00:00,1,0,1,13,3,10,9,9,0,4,5
15-02-2020 06:00:00,1,1,0,29,6,23,16,16,0,9,14
15-02-2020 07:00:00,1,1,0,35,6,29,36,34,2,4,22
15-02-2020 08:00:00,1,1,0,50,12,38,22,20,2,8,19
15-02-2020 09:00:00,3,3,0,61,31,30,21,19,2,9,20
15-02-2020 10:00:00,0,0,0,39,12,27,19,13,6,14,22
15-02-2020 11:00:00,3,1,2,39,14,25,18,16,2,12,23
15-02-2020 12:00:00,0,0,0,48,21,27,16,15,1,24,25
15-02-2020 13:00:00,3,2,1,61,39,22,27,14,13,17,26
15-02-2020 14:00:00,2,0,2,38,22,16,9,5,4,18,13
15-02-2020 15:00:00,2,2,0,46,22,24,22,12,10,18,9
15-02-2020 16:00:00,2,2,0,58,26,32,23,13,10,20,8
15-02-2020 17:00:00,3,2,1,57,33,24,22,13,9,17,2
15-02-2020 18:00:00,0,0,0,54,24,30,20,12,8,24,12
15-02-2020 19:00:00,0,0,0,34,13,21,20,12,8,18,7
15-02-2020 20:00:00,2,1,1,40,23,17,16,10,6,19,8
15-02-2020 21:00:00,3,1,2,15,9,6,19,10,9,21,10
15-02-2020 22:00:00,1,0,1,22,12,10,9,5,4,13,7
15-02-2020 23:00:00,2,2,0,17,12,5,7,0,7,10,2
16-02-2020 00:00:00,2,1,1,13,12,1,5,1,4,11,4
16-02-2020 01:00:00,1,0,1,11,8,3,2,0,2,11,2
16-02-2020 02:00:00,2,1,1,8,6,2,0,0,0,4,1
16-02-2020 03:00:00,0,0,0,3,2,1,1,0,1,3,1
16-02-2020 04:00:00,1,0,1,4,1,3,0,0,0,5,3
16-02-2020 05:00:00,0,0,0,8,4,4,7,7,0,4,2
16-02-2020 06:00:00,1,1,0,20,4,16,9,9,0,15,9
16-02-2020 07:00:00,1,1,0,19,3,16,17,14,3,6,8
16-02-2020 08:00:00,2,2,0,24,5,19,14,13,1,3,28
16-02-2020 09:00:00,1,0,1,49,13,36,13,12,1,8,15
16-02-2020 10:00:00,2,1,1,56,12,44,23,13,10,7,21
16-02-2020 11:00:00,3,2,1,43,11,32,25,18,7,12,19
16-02-2020 12:00:00,2,2,0,71,29,42,23,16,7,12,16
16-02-2020 13:00:00,1,1,0,59,30,29,35,18,17,27,19
16-02-2020 14:00:00,3,2,1,39,17,22,27,15,12,10,11
16-02-2020 15:00:00,3,0,3,53,23,30,26,15,11,21,14
16-02-2020 16:00:00,4,3,1,47,24,23,31,18,13,29,6
16-02-2020 17:00:00,0,0,0,48,28,20,15,7,8,29,5
16-02-2020 18:00:00,2,2,0,49,23,26,26,11,15,34,16
16-02-2020 19:00:00,1,0,1,42,21,21,15,9,6,28,10
16-02-2020 20:00:00,2,1,1,33,20,13,15,8,7,14,3
16-02-2020 21:00:00,5,2,3,36,21,15,14,9,5,12,0
16-02-2020 22:00:00,2,1,1,26,21,5,9,6,3,20,5
16-02-2020 23:00:00,0,0,0,11,5,6,7,2,5,10,4
17-02-2020 00:00:00,0,0,0,9,8,1,2,0,2,7,3
17-02-2020 01:00:00,0,0,0,5,4,1,1,0,1,1,0
17-02-2020 02:00:00,1,1,0,3,2,1,0,0,0,2,1
17-02-2020 03:00:00,0,0,0,3,1,2,3,3,0,2,2
17-02-2020 04:00:00,0,0,0,9,3,6,8,7,1,4,5
17-02-2020 05:00:00,0,0,0,31,4,27,18,17,1,4,11
17-02-2020 06:00:00,4,3,1,131,17,114,119,116,3,6,84
17-02-2020 07:00:00,16,15,1,357,56,301,170,155,15,29,189
17-02-2020 08:00:00,39,36,3,853,67,786,337,312,25,51,384
17-02-2020 09:00:00,12,11,1,299,30,269,156,139,17,17,212
17-02-2020 10:00:00,6,5,1,75,15,60,45,40,5,15,66
17-02-2020 11:00:00,3,3,0,66,24,42,24,20,4,17,32
17-02-2020 12:00:00,2,1,1,63,21,42,37,27,10,27,44
17-02-2020 13:00:00,1,0,1,81,26,55,37,21,16,42,37
17-02-2020 14:00:00,1,0,1,64,30,34,24,18,6,29,25
17-02-2020 15:00:00,1,1,0,113,69,44,35,14,21,44,16
17-02-2020 16:00:00,10,5,5,173,114,59,67,31,36,150,44
17-02-2020 17:00:00,10,4,6,578,477,101,142,53,89,315,51
17-02-2020 18:00:00,11,7,4,430,330,100,145,40,105,343,42
17-02-2020 19:00:00,5,3,2,184,131,53,60,19,41,112,5
17-02-2020 20:00:00,3,3,0,103,70,33,39,19,20,78,7
17-02-2020 21:00:00,3,3,0,71,49,22,26,12,14,38,10
17-02-2020 22:00:00,3,3,0,55,37,18,27,9,18,32,6
17-02-2020 23:00:00,0,0,0,23,14,9,11,4,7,21,2
18-02-2020 00:00:00,1,1,0,12,9,3,2,1,1,2,2
18-02-2020 01:00:00,0,0,0,7,6,1,1,0,1,1,0
18-02-2020 02:00:00,0,0,0,3,3,0,0,0,0,8,1
18-02-2020 03:00:00,0,0,0,4,1,3,3,3,0,3,4
18-02-2020 04:00:00,1,0,1,7,1,6,6,6,0,3,5
18-02-2020 05:00:00,1,1,0,31,6,25,19,17,2,5,15
18-02-2020 06:00:00,6,5,1,126,16,110,123,121,2,8,56
18-02-2020 07:00:00,11,8,3,344,46,298,158,148,10,25,165
18-02-2020 08:00:00,35,30,5,833,49,784,324,307,17,44,337
18-02-2020 09:00:00,15,12,3,319,34,285,151,132,19,13,189
18-02-2020 10:00:00,3,3,0,89,18,71,38,31,7,11,52
18-02-2020 11:00:00,4,4,0,59,18,41,29,23,6,17,28
18-02-2020 12:00:00,6,5,1,78,25,53,42,29,13,37,39
18-02-2020 13:00:00,5,5,0,70,32,38,46,32,14,39,19
18-02-2020 14:00:00,4,2,2,64,32,32,14,11,3,17,17
18-02-2020 15:00:00,3,0,3,102,63,39,32,17,15,35,23
18-02-2020 16:00:00,11,6,5,193,122,71,69,31,38,150,52
18-02-2020 17:00:00,15,7,8,510,392,118,151,56,95,334,73
18-02-2020 18:00:00,12,6,6,449,339,110,125,39,86,291,42
18-02-2020 19:00:00,4,3,1,221,155,66,64,28,36,134,12
18-02-2020 20:00:00,5,2,3,124,92,32,39,15,24,91,12
18-02-2020 21:00:00,4,2,2,92,62,30,38,13,25,57,9
18-02-2020 22:00:00,0,0,0,54,33,21,25,6,19,44,4
18-02-2020 23:00:00,3,2,1,31,24,7,13,2,11,17,4
19-02-2020 00:00:00,2,1,1,16,14,2,5,1,4,9,4
19-02-2020 01:00:00,0,0,0,10,6,4,1,1,0,3,0
19-02-2020 02:00:00,0,0,0,5,5,0,0,0,0,3,2
19-02-2020 03:00:00,0,0,0,7,3,4,2,2,0,4,3
19-02-2020 04:00:00,0,0,0,5,0,5,6,6,0,1,8
19-02-2020 05:00:00,0,0,0,42,13,29,18,17,1,2,21
19-02-2020 06:00:00,3,3,0,127,14,113,143,139,4,16,81
19-02-2020 07:00:00,11,9,2,376,51,325,158,141,17,28,199
19-02-2020 08:00:00,34,29,5,819,80,739,278,259,19,32,366
19-02-2020 09:00:00,10,8,2,360,47,313,129,115,14,16,129
19-02-2020 10:00:00,4,2,2,83,19,64,28,21,7,9,49
19-02-2020 11:00:00,4,4,0,59,13,46,36,32,4,6,25
19-02-2020 12:00:00,4,2,2,70,27,43,32,21,11,31,29
19-02-2020 13:00:00,6,4,2,99,38,61,39,22,17,29,29
19-02-2020 14:00:00,6,3,3,84,36,48,25,15,10,33,24
19-02-2020 15:00:00,2,2,0,104,56,48,45,19,26,44,16
19-02-2020 16:00:00,9,8,1,196,118,78,64,24,40,109,34
19-02-2020 17:00:00,10,6,4,482,393,89,154,50,104,295,71
19-02-2020 18:00:00,12,7,5,469,383,86,127,42,85,251,37
19-02-2020 19:00:00,4,0,4,177,130,47,60,25,35,115,8
19-02-2020 20:00:00,2,2,0,123,81,42,35,13,22,69,4
19-02-2020 21:00:00,2,1,1,59,41,18,31,13,18,64,1
19-02-2020 22:00:00,4,2,2,69,53,16,21,9,12,31,3
19-02-2020 23:00:00,0,0,0,45,34,11,14,4,10,24,6
20-02-2020 00:00:00,0,0,0,17,13,4,6,1,5,11,1
20-02-2020 01:00:00,1,0,1,6,3,3,2,2,0,2,0
20-02-2020 02:00:00,0,0,0,5,5,0,2,2,0,2,3
20-02-2020 03:00:00,0,0,0,3,1,2,1,1,0,5,1
20-02-2020 04:00:00,0,0,0,9,3,6,5,5,0,4,6
20-02-2020 05:00:00,0,0,0,28,5,23,21,21,0,2,15
20-02-2020 06:00:00,4,4,0,106,12,94,123,121,2,15,54
20-02-2020 07:00:00,7,4,3,325,41,284,141,130,11,24,159
20-02-2020 08:00:00,31,30,1,767,64,703,292,269,23,45,311
20-02-2020 09:00:00,5,4,1,350,35,315,155,139,16,30,159
20-02-2020 10:00:00,4,2,2,87,18,69,36,32,4,17,58
20-02-2020 11:00:00,5,4,1,75,30,45,26,22,4,21,42
20-02-2020 12:00:00,2,1,1,93,29,64,31,21,10,41,54
20-02-2020 13:00:00,2,2,0,100,40,60,48,37,11,39,43
20-02-2020 14:00:00,3,0,3,70,39,31,29,17,12,28,24
20-02-2020 15:00:00,6,2,4,96,55,41,37,19,18,32,17
20-02-2020 16:00:00,11,4,7,187,117,70,77,32,45,118,38
20-02-2020 17:00:00,9,5,4,447,344,103,152,56,96,249,44
20-02-2020 18:00:00,6,3,3,402,305,97,101,33,68,235,37
20-02-2020 19:00:00,3,3,0,214,139,75,57,20,37,115,25
20-02-2020 20:00:00,4,2,2,133,91,42,44,23,21,78,9
20-02-2020 21:00:00,6,3,3,76,58,18,25,9,16,56,6
20-02-2020 22:00:00,1,1,0,61,42,19,26,8,18,25,3
20-02-2020 23:00:00,2,1,1,34,22,12,8,1,7,39,6
21-02-2020 00:00:00,2,1,1,26,22,4,7,4,3,15,9
21-02-2020 01:00:00,5,4,1,7,7,0,3,1,2,5,1
21-02-2020 02:00:00,1,0,1,4,3,1,1,1,0,3,1
21-02-2020 03:00:00,2,0,2,4,2,2,2,2,0,5,0
21-02-2020 04:00:00,1,1,0,10,4,6,4,4,0,3,4
21-02-2020 05:00:00,2,2,0,34,8,26,23,23,0,8,17
21-02-2020 06:00:00,5,5,0,135,13,122,106,105,1,14,63
21-02-2020 07:00:00,7,7,0,308,34,274,124,113,11,30,122
21-02-2020 08:00:00,26,24,2,631,55,576,245,229,16,26,306
21-02-2020 09:00:00,7,5,2,267,23,244,109,99,10,24,169
21-02-2020 10:00:00,2,2,0,79,18,61,40,33,7,13,44
21-02-2020 11:00:00,5,2,3,85,29,56,38,34,4,25,30
21-02-2020 12:00:00,3,3,0,77,28,49,33,24,9,40,40
21-02-2020 13:00:00,3,0,3,100,48,52,47,35,12,53,30
21-02-2020 14:00:00,14,7,7,96,49,47,39,21,18,47,33
21-02-2020 15:00:00,1,1,0,105,56,49,47,22,25,61,29
21-02-2020 16:00:00,6,4,2,207,134,73,78,29,49,115,47
21-02-2020 17:00:00,8,1,7,403,302,101,129,46,83,231,52
21-02-2020 18:00:00,4,3,1,274,214,60,85,29,56,177,36
21-02-2020 19:00:00,4,1,3,157,102,55,44,15,29,75,15
21-02-2020 20:00:00,4,2,2,89,59,30,26,11,15,50,12
21-02-2020 21:00:00,5,4,1,52,35,17,28,7,21,43,9
21-02-2020 22:00:00,1,1,0,45,33,12,22,7,15,27,11
21-02-2020 23:00:00,1,1,0,36,29,7,12,3,9,37,5
22-02-2020 00:00:00,0,0,0,24,16,8,3,0,3,16,2
22-02-2020 01:00:00,1,1,0,12,10,2,3,0,3,10,4
22-02-2020 02:00:00,1,0,1,6,4,2,3,1,2,7,2
22-02-2020 03:00:00,0,0,0,10,7,3,0,0,0,6,1
22-02-2020 04:00:00,2,1,1,4,1,3,3,3,0,5,7
22-02-2020 05:00:00,0,0,0,16,2,14,5,5,0,4,5
22-02-2020 06:00:00,0,0,0,33,4,29,21,20,1,7,21
22-02-2020 07:00:00,1,1,0,49,9,40,30,29,1,4,14
22-02-2020 08:00:00,7,6,1,56,10,46,28,25,3,5,22
22-02-2020 09:00:00,4,3,1,75,15,60,35,26,9,17,35
22-02-2020 10:00:00,4,1,3,75,38,37,20,16,4,17,36
22-02-2020 11:00:00,1,1,0,65,29,36,23,14,9,31,27
22-02-2020 12:00:00,3,3,0,78,34,44,25,17,8,28,27
22-02-2020 13:00:00,5,1,4,78,36,42,36,19,17,41,31
22-02-2020 14:00:00,3,1,2,87,38,49,39,29,10,33,20
22-02-2020 15:00:00,2,0,2,77,37,40,27,14,13,37,12
22-02-2020 16:00:00,5,5,0,54,20,34,35,24,11,43,13
22-02-2020 17:00:00,1,1,0,79,31,48,28,15,13,19,5
22-02-2020 18:00:00,4,2,2,65,32,33,22,13,9,32,17
22-02-2020 19:00:00,2,1,1,58,31,27,27,19,8,31,16
22-02-2020 20:00:00,2,1,1,38,13,25,24,14,10,29,16
22-02-2020 21:00:00,3,1,2,31,19,12,17,12,5,27,9
22-02-2020 22:00:00,2,2,0,22,14,8,9,5,4,13,5
22-02-2020 23:00:00,1,1,0,30,24,6,9,3,6,17,8
23-02-2020 00:00:00,1,1,0,21,16,5,7,1,6,8,1
23-02-2020 01:00:00,2,1,1,7,6,1,2,0,2,7,1
23-02-2020 02:00:00,0,0,0,11,10,1,1,0,1,7,6
23-02-2020 03:00:00,1,1,0,13,9,4,3,2,1,4,2
23-02-2020 04:00:00,1,0,1,5,2,3,1,0,1,1,0
23-02-2020 05:00:00,0,0,0,11,3,8,1,1,0,4,10
23-02-2020 06:00:00,1,1,0,18,3,15,18,17,1,8,14
23-02-2020 07:00:00,2,1,1,36,11,25,18,17,1,4,17
23-02-2020 08:00:00,2,1,1,30,9,21,14,13,1,10,15
23-02-2020 09:00:00,2,1,1,47,14,33,27,19,8,14,21
23-02-2020 10:00:00,1,1,0,65,16,49,20,15,5,20,19
23-02-2020 11:00:00,1,1,0,68,25,43,30,22,8,23,25
23-02-2020 12:00:00,4,3,1,71,26,45,38,25,13,30,27
23-02-2020 13:00:00,4,3,1,89,46,43,37,26,11,34,51
23-02-2020 14:00:00,1,0,1,90,36,54,43,33,10,25,26
23-02-2020 15:00:00,3,3,0,62,26,36,31,24,7,28,25
23-02-2020 16:00:00,2,1,1,59,25,34,36,19,17,25,20
23-02-2020 17:00:00,3,2,1,65,28,37,29,14,15,34,14
23-02-2020 18:00:00,3,2,1,66,37,29,28,13,15,31,16
23-02-2020 19:00:00,2,1,1,68,42,26,27,12,15,36,9
23-02-2020 20:00:00,4,1,3,55,29,26,22,9,13,29,4
23-02-2020 21:00:00,2,1,1,33,18,15,17,7,10,27,6
23-02-2020 22:00:00,2,1,1,24,15,9,16,6,10,14,3
23-02-2020 23:00:00,1,0,1,16,12,4,6,0,6,18,4
24-02-2020 00:00:00,0,0,0,7,4,3,4,1,3,5,1
24-02-2020 01:00:00,0,0,0,1,1,0,0,0,0,3,2
24-02-2020 02:00:00,0,0,0,2,2,0,0,0,0,0,1
24-02-2020 03:00:00,0,0,0,4,2,2,2,2,0,1,0
24-02-2020 04:00:00,0,0,0,8,2,6,6,6,0,4,7
24-02-2020 05:00:00,0,0,0,27,6,21,13,11,2,2,19
24-02-2020 06:00:00,2,2,0,126,19,107,124,122,2,15,71
24-02-2020 07:00:00,10,8,2,348,44,304,165,155,10,32,139
24-02-2020 08:00:00,38,35,3,822,78,744,303,280,23,43,370
24-02-2020 09:00:00,12,12,0,349,38,311,144,126,18,28,192
24-02-2020 10:00:00,1,1,0,89,23,66,35,33,2,14,54
24-02-2020 11:00:00,4,3,1,65,13,52,18,15,3,4,20
24-02-2020 12:00:00,5,2,3,66,24,42,37,29,8,33,39
24-02-2020 13:00:00,2,1,1,90,40,50,23,17,6,43,29
24-02-2020 14:00:00,2,1,1,79,35,44,37,24,13,37,26
24-02-2020 15:00:00,3,2,1,82,49,33,39,24,15,51,30
24-02-2020 16:00:00,8,5,3,207,137,70,70,39,31,163,33
24-02-2020 17:00:00,15,6,9,527,432,95,168,51,117,366,64
24-02-2020 18:00:00,11,3,8,438,349,89,126,37,89,272,35
24-02-2020 19:00:00,7,4,3,172,128,44,83,29,54,87,20
24-02-2020 20:00:00,3,2,1,121,85,36,43,23,20,67,14
24-02-2020 21:00:00,5,2,3,68,48,20,30,8,22,39,8
24-02-2020 22:00:00,1,0,1,45,34,11,27,15,12,24,9
24-02-2020 23:00:00,1,1,0,28,23,5,8,3,5,19,3
25-02-2020 00:00:00,0,0,0,17,9,8,1,0,1,6,1
25-02-2020 01:00:00,0,0,0,3,3,0,1,1,0,5,1
25-02-2020 02:00:00,0,0,0,6,6,0,0,0,0,2,0
25-02-2020 03:00:00,0,0,0,3,2,1,2,1,1,5,2
25-02-2020 04:00:00,0,0,0,6,0,6,7,7,0,2,5
25-02-2020 05:00:00,1,0,1,41,7,34,15,15,0,6,24
25-02-2020 06:00:00,4,4,0,142,26,116,132,127,5,17,90
25-02-2020 07:00:00,16,13,3,427,79,348,176,164,12,43,209
25-02-2020 08:00:00,37,33,4,1035,88,947,355,328,27,48,328
25-02-2020 09:00:00,22,21,1,390,64,326,162,141,21,32,222
25-02-2020 10:00:00,8,5,3,95,17,78,50,46,4,11,47
25-02-2020 11:00:00,3,3,0,82,24,58,21,20,1,14,39
25-02-2020 12:00:00,3,2,1,101,36,65,38,23,15,36,52
25-02-2020 13:00:00,5,3,2,108,51,57,34,22,12,48,25
25-02-2020 14:00:00,5,4,1,104,46,58,30,23,7,43,24
25-02-2020 15:00:00,6,4,2,116,57,59,42,26,16,50,24
25-02-2020 16:00:00,11,6,5,264,190,74,94,42,52,172,34
25-02-2020 17:00:00,10,1,9,532,423,109,175,63,112,389,61
25-02-2020 18:00:00,8,3,5,474,366,108,122,34,88,341,49
25-02-2020 19:00:00,4,0,4,225,160,65,78,25,53,130,9
25-02-2020 20:00:00,8,5,3,118,85,33,52,21,31,73,4
25-02-2020 21:00:00,2,1,1,84,57,27,23,16,7,58,16
25-02-2020 22:00:00,0,0,0,61,46,15,19,7,12,34,6
25-02-2020 23:00:00,1,1,0,44,31,13,12,4,8,24,9
26-02-2020 00:00:00,1,0,1,13,11,2,2,1,1,16,1
26-02-2020 01:00:00,0,0,0,8,6,2,0,0,0,2,1
26-02-2020 02:00:00,0,0,0,4,3,1,0,0,0,6,0
26-02-2020 03:00:00,1,0,1,6,4,2,2,2,0,5,2
26-02-2020 04:00:00,1,1,0,6,1,5,7,6,1,5,6
26-02-2020 05:00:00,0,0,0,41,11,30,23,23,0,1,17
26-02-2020 06:00:00,3,2,1,134,20,114,131,125,6,19,81
26-02-2020 07:00:00,10,10,0,362,43,319,175,162,13,34,208
26-02-2020 08:00:00,34,31,3,891,67,824,325,299,26,56,387
26-02-2020 09:00:00,22,20,2,367,42,325,162,139,23,29,161
26-02-2020 10:00:00,3,0,3,103,21,82,45,38,7,11,51
26-02-2020 11:00:00,1,1,0,66,18,48,34,29,5,16,52
26-02-2020 12:00:00,2,1,1,90,38,52,33,25,8,33,39
26-02-2020 13:00:00,3,2,1,134,67,67,38,22,16,42,36
26-02-2020 14:00:00,4,1,3,96,42,54,46,28,18,52,19
26-02-2020 15:00:00,5,4,1,108,63,45,40,19,21,67,30
26-02-2020 16:00:00,6,2,4,218,149,69,86,38,48,149,38
26-02-2020 17:00:00,11,4,7,536,412,124,178,61,117,390,56
26-02-2020 18:00:00,11,7,4,454,357,97,130,43,87,268,34
26-02-2020 19:00:00,6,4,2,227,162,65,52,20,32,134,10
26-02-2020 20:00:00,4,3,1,143,86,57,38,17,21,90,1
26-02-2020 21:00:00,5,4,1,73,56,17,37,18,19,66,10
26-02-2020 22:00:00,2,1,1,82,61,21,21,11,10,41,2
26-02-2020 23:00:00,2,1,1,41,31,10,13,2,11,35,4
27-02-2020 00:00:00,1,1,0,21,16,5,3,1,2,13,1
27-02-2020 01:00:00,0,0,0,5,3,2,0,0,0,5,1
27-02-2020 02:00:00,1,1,0,4,4,0,1,1,0,5,0
27-02-2020 03:00:00,1,0,1,7,4,3,0,0,0,5,2
27-02-2020 04:00:00,0,0,0,13,4,9,8,8,0,1,10
27-02-2020 05:00:00,1,0,1,32,8,24,23,22,1,6,17
27-02-2020 06:00:00,5,4,1,125,10,115,135,132,3,19,105
27-02-2020 07:00:00,11,10,1,376,51,325,166,153,13,26,180
27-02-2020 08:00:00,33,29,4,985,95,890,323,296,27,52,401
27-02-2020 09:00:00,13,11,2,355,47,308,164,141,23,23,178
27-02-2020 10:00:00,2,2,0,104,20,84,46,40,6,24,58
27-02-2020 11:00:00,4,4,0,68,14,54,35,29,6,14,34
27-02-2020 12:00:00,9,8,1,103,31,72,66,42,24,40,55
27-02-2020 13:00:00,3,2,1,114,54,60,43,29,14,48,42
27-02-2020 14:00:00,4,2,2,104,47,57,35,18,17,57,31
27-02-2020 15:00:00,3,2,1,123,71,52,44,19,25,69,33
27-02-2020 16:00:00,10,6,4,248,161,87,79,41,38,171,44
27-02-2020 17:00:00,10,2,8,468,373,95,173,66,107,355,62
27-02-2020 18:00:00,10,3,7,441,343,98,126,42,84,274,43
27-02-2020 19:00:00,5,2,3,221,164,57,75,25,50,149,28
27-02-2020 20:00:00,5,3,2,143,106,37,41,17,24,96,17
27-02-2020 21:00:00,0,0,0,86,58,28,41,16,25,69,7
27-02-2020 22:00:00,3,3,0,73,50,23,29,9,20,49,5
27-02-2020 23:00:00,4,4,0,42,31,11,13,1,12,32,13
28-02-2020 00:00:00,1,0,1,24,21,3,5,1,4,15,1
28-02-2020 01:00:00,0,0,0,5,5,0,1,1,0,6,1
28-02-2020 02:00:00,0,0,0,5,5,0,1,1,0,7,1
28-02-2020 03:00:00,1,0,1,1,1,0,3,3,0,4,0
28-02-2020 04:00:00,1,1,0,12,3,9,7,5,2,3,4
28-02-2020 05:00:00,2,1,1,34,10,24,21,20,1,6,23
28-02-2020 06:00:00,4,3,1,109,11,98,119,115,4,11,70
28-02-2020 07:00:00,8,7,1,308,45,263,129,121,8,18,146
28-02-2020 08:00:00,22,21,1,677,72,605,250,232,18,36,267
28-02-2020 09:00:00,13,12,1,323,32,291,130,119,11,23,124
28-02-2020 10:00:00,3,3,0,83,17,66,34,29,5,20,49
28-02-2020 11:00:00,3,2,1,86,24,62,35,25,10,18,36
28-02-2020 12:00:00,6,4,2,119,48,71,40,24,16,50,35
28-02-2020 13:00:00,2,2,0,101,37,64,37,24,13,51,40
28-02-2020 14:00:00,2,1,1,99,49,50,50,32,18,66,42
28-02-2020 15:00:00,6,4,2,127,71,56,44,25,19,75,32
28-02-2020 16:00:00,12,5,7,238,154,84,80,32,48,132,48
28-02-2020 17:00:00,5,1,4,439,342,97,131,58,73,265,69
28-02-2020 18:00:00,5,4,1,269,202,67,95,33,62,177,34
28-02-2020 19:00:00,3,1,2,136,83,53,59,25,34,92,34
28-02-2020 20:00:00,4,4,0,93,62,31,30,16,14,58,14
28-02-2020 21:00:00,1,0,1,50,28,22,21,9,12,53,19
28-02-2020 22:00:00,1,1,0,70,42,28,32,12,20,29,14
28-02-2020 23:00:00,1,1,0,56,43,13,23,6,17,28,5
29-02-2020 00:00:00,0,0,0,40,28,12,14,2,12,15,3
29-02-2020 01:00:00,0,0,0,13,9,4,7,3,4,5,0
29-02-2020 02:00:00,0,0,0,10,7,3,1,0,1,10,0
29-02-2020 03:00:00,0,0,0,11,6,5,2,1,1,9,2
29-02-2020 04:00:00,1,0,1,10,5,5,3,2,1,2,7
29-02-2020 05:00:00,1,1,0,12,0,12,4,4,0,3,8
29-02-2020 06:00:00,0,0,0,33,8,25,22,21,1,15,16
29-02-2020 07:00:00,1,1,0,58,15,43,40,40,0,6,29
29-02-2020 08:00:00,2,2,0,59,10,49,28,25,3,16,29
29-02-2020 09:00:00,6,5,1,82,16,66,49,44,5,20,44
29-02-2020 10:00:00,1,1,0,70,26,44,30,16,14,16,23
29-02-2020 11:00:00,3,2,1,54,10,44,28,23,5,22,29
29-02-2020 12:00:00,4,2,2,72,18,54,34,19,15,37,33
29-02-2020 13:00:00,4,1,3,69,32,37,30,16,14,34,25
29-02-2020 14:00:00,5,1,4,68,37,31,22,14,8,24,22
29-02-2020 15:00:00,3,3,0,44,15,29,24,12,12,22,11
29-02-2020 16:00:00,3,2,1,35,16,19,19,14,5,24,14
29-02-2020 17:00:00,1,0,1,51,29,22,23,14,9,20,9
29-02-2020 18:00:00,0,0,0,40,20,20,25,13,12,26,9
29-02-2020 19:00:00,0,0,0,49,22,27,9,5,4,21,11
29-02-2020 20:00:00,3,3,0,38,20,18,12,8,4,17,6
29-02-2020 21:00:00,2,1,1,19,9,10,13,10,3,2,5
29-02-2020 22:00:00,0,0,0,31,14,17,11,6,5,13,3
29-02-2020 23:00:00,1,0,1,18,8,10,7,1,6,8,2
01-03-2020 00:00:00,1,1,0,18,11,7,7,0,7,10,3
01-03-2020 01:00:00,0,0,0,6,5,1,2,0,2,7,3
01-03-2020 02:00:00,0,0,0,15,6,9,0,0,0,6,0
01-03-2020 03:00:00,1,0,1,3,3,0,1,1,0,5,1
01-03-2020 04:00:00,0,0,0,12,4,8,2,1,1,1,1
01-03-2020 05:00:00,2,1,1,6,1,5,4,3,1,1,4
01-03-2020 06:00:00,0,0,0,21,5,16,15,12,3,5,11
01-03-2020 07:00:00,0,0,0,38,14,24,8,8,0,8,14
01-03-2020 08:00:00,1,0,1,24,3,21,20,20,0,8,4
01-03-2020 09:00:00,4,1,3,46,16,30,12,10,2,14,21
01-03-2020 10:00:00,4,4,0,61,18,43,30,20,10,15,24
01-03-2020 11:00:00,3,3,0,56,17,39,24,19,5,21,22
01-03-2020 12:00:00,2,1,1,72,22,50,20,15,5,22,21
01-03-2020 13:00:00,3,3,0,47,25,22,42,30,12,21,33
01-03-2020 14:00:00,2,2,0,75,34,41,33,17,16,31,28
01-03-2020 15:00:00,1,1,0,62,29,33,16,7,9,23,20
01-03-2020 16:00:00,6,2,4,59,31,28,29,16,13,39,13
01-03-2020 17:00:00,4,3,1,63,24,39,26,21,5,18,12
01-03-2020 18:00:00,2,1,1,68,34,34,21,7,14,36,18
01-03-2020 19:00:00,4,1,3,63,30,33,19,11,8,33,11
01-03-2020 20:00:00,1,1,0,40,20,20,20,10,10,16,8
01-03-2020 21:00:00,0,0,0,49,31,18,19,8,11,14,6
01-03-2020 22:00:00,2,1,1,33,23,10,13,5,8,21,9
01-03-2020 23:00:00,0,0,0,17,14,3,5,1,4,12,4
02-03-2020 00:00:00,1,0,1,13,10,3,5,1,4,8,1
02-03-2020 01:00:00,0,0,0,3,1,2,2,2,0,3,1
02-03-2020 02:00:00,0,0,0,5,5,0,0,0,0,3,0
02-03-2020 03:00:00,0,0,0,6,3,3,4,4,0,3,1
02-03-2020 04:00:00,0,0,0,9,3,6,5,4,1,3,3
02-03-2020 05:00:00,1,0,1,28,5,23,21,20,1,4,18
02-03-2020 06:00:00,4,3,1,143,15,128,127,123,4,16,71
02-03-2020 07:00:00,12,12,0,415,54,361,169,154,15,28,127
02-03-2020 08:00:00,36,31,5,876,81,795,327,310,17,43,344
02-03-2020 09:00:00,18,18,0,378,49,329,158,142,16,23,238
02-03-2020 10:00:00,1,0,1,82,16,66,44,38,6,12,61
02-03-2020 11:00:00,4,2,2,67,20,47,27,21,6,19,25
02-03-2020 12:00:00,5,3,2,83,29,54,47,33,14,37,31
02-03-2020 13:00:00,8,5,3,88,43,45,58,39,19,57,43
02-03-2020 14:00:00,5,5,0,92,43,49,28,17,11,51,23
02-03-2020 15:00:00,8,3,5,90,51,39,34,13,21,61,20
02-03-2020 16:00:00,7,3,4,237,166,71,76,39,37,158,40
02-03-2020 17:00:00,12,3,9,578,458,120,151,65,86,425,74
02-03-2020 18:00:00,4,3,1,487,373,114,129,41,88,369,51
02-03-2020 19:00:00,6,3,3,207,139,68,86,28,58,139,9
02-03-2020 20:00:00,2,2,0,104,77,27,33,14,19,92,13
02-03-2020 21:00:00,3,2,1,92,62,30,30,12,18,59,9
02-03-2020 22:00:00,0,0,0,49,30,19,21,5,16,44,19
02-03-2020 23:00:00,1,0,1,27,25,2,12,3,9,13,6
03-03-2020 00:00:00,1,1,0,8,8,0,5,2,3,10,1
03-03-2020 01:00:00,0,0,0,4,2,2,0,0,0,1,0
03-03-2020 02:00:00,2,0,2,6,6,0,0,0,0,5,0
03-03-2020 03:00:00,0,0,0,2,1,1,4,3,1,2,1
03-03-2020 04:00:00,0,0,0,5,1,4,5,5,0,1,7
03-03-2020 05:00:00,1,0,1,32,6,26,22,20,2,3,23
03-03-2020 06:00:00,6,5,1,141,16,125,120,117,3,12,57
03-03-2020 07:00:00,16,15,1,443,71,372,201,180,21,43,194
03-03-2020 08:00:00,36,33,3,1001,113,888,334,306,28,49,336
03-03-2020 09:00:00,15,15,0,357,38,319,165,145,20,26,218
03-03-2020 10:00:00,5,2,3,106,19,87,34,29,5,14,56
03-03-2020 11:00:00,7,4,3,69,25,44,37,27,10,15,34
03-03-2020 12:00:00,4,2,2,100,28,72,58,44,14,38,35
03-03-2020 13:00:00,6,3,3,123,61,62,46,31,15,48,51
03-03-2020 14:00:00,6,2,4,126,57,69,46,32,14,34,29
03-03-2020 15:00:00,4,3,1,129,68,61,41,17,24,61,46
03-03-2020 16:00:00,20,12,8,239,159,80,94,39,55,192,50
03-03-2020 17:00:00,16,8,8,604,474,130,153,53,100,401,73
03-03-2020 18:00:00,10,4,6,504,379,125,139,40,99,331,50
03-03-2020 19:00:00,7,5,2,210,144,66,77,34,43,157,21
03-03-2020 20:00:00,8,6,2,143,95,48,45,21,24,85,7
03-03-2020 21:00:00,3,2,1,88,66,22,35,13,22,64,6
03-03-2020 22:00:00,1,0,1,68,43,25,17,8,9,43,4
03-03-2020 23:00:00,1,1,0,37,31,6,19,3,16,37,6
04-03-2020 00:00:00,2,2,0,14,8,6,4,3,1,13,5
04-03-2020 01:00:00,1,0,1,5,5,0,1,0,1,9,0
04-03-2020 02:00:00,0,0,0,9,8,1,1,1,0,3,0
04-03-2020 03:00:00,0,0,0,4,2,2,2,2,0,4,0
04-03-2020 04:00:00,1,0,1,6,1,5,4,4,0,1,9
04-03-2020 05:00:00,3,0,3,37,8,29,25,23,2,2,23
04-03-2020 06:00:00,0,0,0,164,26,138,119,113,6,19,69
04-03-2020 07:00:00,19,16,3,414,69,345,194,176,18,35,195
04-03-2020 08:00:00,45,42,3,967,90,877,326,303,23,62,395
04-03-2020 09:00:00,16,13,3,390,56,334,162,143,19,21,156
04-03-2020 10:00:00,6,5,1,105,27,78,43,40,3,14,42
04-03-2020 11:00:00,7,5,2,80,23,57,27,19,8,14,45
04-03-2020 12:00:00,7,6,1,126,47,79,52,29,23,50,45
04-03-2020 13:00:00,7,4,3,125,49,76,56,38,18,58,51
04-03-2020 14:00:00,5,3,2,108,49,59,45,24,21,57,31
04-03-2020 15:00:00,1,0,1,104,53,51,40,21,19,72,31
04-03-2020 16:00:00,18,8,10,248,162,86,94,48,46,198,49
04-03-2020 17:00:00,12,6,6,574,436,138,164,62,102,429,101
04-03-2020 18:00:00,10,6,4,514,398,116,137,52,85,320,39
04-03-2020 19:00:00,4,0,4,205,139,66,60,30,30,139,17
04-03-2020 20:00:00,4,3,1,151,92,59,47,17,30,76,9
04-03-2020 21:00:00,2,2,0,90,66,24,36,7,29,83,13
04-03-2020 22:00:00,5,4,1,54,38,16,25,8,17,41,10
04-03-2020 23:00:00,2,1,1,46,39,7,14,3,11,37,9
05-03-2020 00:00:00,1,0,1,15,10,5,2,0,2,8,2
05-03-2020 01:00:00,0,0,0,4,2,2,1,0,1,10,0
05-03-2020 02:00:00,0,0,0,5,4,1,0,0,0,3,0
05-03-2020 03:00:00,2,0,2,5,2,3,2,2,0,3,1
05-03-2020 04:00:00,0,0,0,10,4,6,3,3,0,3,5
05-03-2020 05:00:00,1,0,1,35,4,31,24,22,2,2,22
05-03-2020 06:00:00,3,3,0,121,12,109,139,132,7,20,70
05-03-2020 07:00:00,14,13,1,423,71,352,187,170,17,35,232
05-03-2020 08:00:00,38,35,3,886,76,810,326,305,21,51,355
05-03-2020 09:00:00,20,16,4,393,45,348,176,158,18,25,247
05-03-2020 10:00:00,2,1,1,118,28,90,46,42,4,17,85
05-03-2020 11:00:00,3,3,0,80,22,58,41,30,11,25,44
05-03-2020 12:00:00,7,4,3,118,44,74,44,23,21,49,55
05-03-2020 13:00:00,4,1,3,107,49,58,46,34,12,62,45
05-03-2020 14:00:00,2,2,0,107,46,61,49,32,17,71,34
05-03-2020 15:00:00,7,4,3,136,71,65,39,15,24,50,35
05-03-2020 16:00:00,16,8,8,243,172,71,83,44,39,196,62
05-03-2020 17:00:00,15,7,8,514,404,110,166,65,101,402,87
05-03-2020 18:00:00,11,2,9,468,373,95,127,43,84,317,66
05-03-2020 19:00:00,8,3,5,214,148,66,68,25,43,142,37
05-03-2020 20:00:00,3,2,1,135,88,47,43,18,25,110,16
05-03-2020 21:00:00,2,1,1,119,81,38,31,17,14,83,8
05-03-2020 22:00:00,1,1,0,83,53,30,36,14,22,48,5
05-03-2020 23:00:00,0,0,0,48,33,15,20,3,17,33,4
06-03-2020 00:00:00,1,1,0,18,14,4,3,1,2,21,6
06-03-2020 01:00:00,1,1,0,8,6,2,1,1,0,8,1
06-03-2020 02:00:00,3,0,3,5,5,0,0,0,0,2,0
06-03-2020 03:00:00,0,0,0,4,3,1,4,3,1,5,4
06-03-2020 04:00:00,1,1,0,10,2,8,4,4,0,5,6
06-03-2020 05:00:00,0,0,0,36,8,28,18,17,1,5,27
06-03-2020 06:00:00,3,3,0,126,14,112,118,116,2,11,88
06-03-2020 07:00:00,13,13,0,354,48,306,150,142,8,27,134
06-03-2020 08:00:00,32,30,2,725,76,649,292,264,28,51,301
06-03-2020 09:00:00,18,13,5,330,35,295,171,156,15,32,213
06-03-2020 10:00:00,5,4,1,86,25,61,36,31,5,15,53
06-03-2020 11:00:00,2,2,0,68,16,52,46,32,14,12,45
06-03-2020 12:00:00,6,2,4,114,29,85,54,37,17,56,50
06-03-2020 13:00:00,5,4,1,135,59,76,48,35,13,79,46
06-03-2020 14:00:00,8,6,2,119,68,51,51,31,20,65,28
06-03-2020 15:00:00,6,5,1,143,83,60,62,28,34,85,31
06-03-2020 16:00:00,6,4,2,271,174,97,77,38,39,171,53
06-03-2020 17:00:00,14,4,10,467,348,119,146,55,91,344,85
06-03-2020 18:00:00,4,0,4,307,227,80,107,36,71,211,39
06-03-2020 19:00:00,5,2,3,181,122,59,54,27,27,102,15
06-03-2020 20:00:00,5,2,3,89,59,30,38,17,21,72,17
06-03-2020 21:00:00,5,3,2,82,51,31,30,15,15,51,16
06-03-2020 22:00:00,3,1,2,65,43,22,27,14,13,41,13
06-03-2020 23:00:00,3,2,1,52,31,21,25,6,19,35,8
07-03-2020 00:00:00,0,0,0,19,14,5,10,5,5,25,6
07-03-2020 01:00:00,1,0,1,9,5,4,5,4,1,11,4
07-03-2020 02:00:00,1,0,1,8,5,3,3,2,1,7,3
07-03-2020 03:00:00,1,0,1,16,12,4,0,0,0,7,2
07-03-2020 04:00:00,0,0,0,10,4,6,1,1,0,7,5
07-03-2020 05:00:00,1,1,0,14,1,13,9,7,2,4,13
07-03-2020 06:00:00,3,1,2,42,14,28,26,24,2,8,19
07-03-2020 07:00:00,0,0,0,57,18,39,39,39,0,12,26
07-03-2020 08:00:00,3,3,0,78,21,57,20,17,3,13,26
07-03-2020 09:00:00,2,1,1,91,26,65,36,33,3,15,39
07-03-2020 10:00:00,4,4,0,66,16,50,32,20,12,15,29
07-03-2020 11:00:00,2,1,1,73,19,54,36,24,12,35,30
07-03-2020 12:00:00,9,7,2,123,31,92,32,17,15,32,41
07-03-2020 13:00:00,5,1,4,95,47,48,46,27,19,44,33
07-03-2020 14:00:00,4,2,2,100,43,57,26,17,9,37,29
07-03-2020 15:00:00,2,2,0,77,29,48,24,13,11,37,36
07-03-2020 16:00:00,4,3,1,76,31,45,23,16,7,38,19
07-03-2020 17:00:00,10,6,4,84,35,49,45,34,11,35,15
07-03-2020 18:00:00,3,1,2,78,38,40,25,15,10,39,30
07-03-2020 19:00:00,2,1,1,60,33,27,27,14,13,32,11
07-03-2020 20:00:00,1,0,1,55,32,23,36,20,16,22,12
07-03-2020 21:00:00,2,1,1,38,15,23,26,8,18,17,11
07-03-2020 22:00:00,2,1,1,34,19,15,18,9,9,27,12
07-03-2020 23:00:00,1,0,1,19,13,6,13,1,12,19,7
08-03-2020 00:00:00,2,1,1,22,18,4,5,2,3,15,2
08-03-2020 01:00:00,2,2,0,17,10,7,4,2,2,11,1
08-03-2020 02:00:00,2,0,2,12,8,4,1,0,1,6,1
08-03-2020 03:00:00,0,0,0,10,5,5,0,0,0,2,1
08-03-2020 04:00:00,1,0,1,10,2,8,1,1,0,4,0
08-03-2020 05:00:00,1,1,0,10,3,7,5,5,0,5,7
08-03-2020 06:00:00,0,0,0,25,4,21,15,14,1,12,15
08-03-2020 07:00:00,1,0,1,32,9,23,22,21,1,9,17
08-03-2020 08:00:00,0,0,0,47,26,21,24,21,3,8,30
08-03-2020 09:00:00,2,0,2,60,23,37,24,17,7,21,38
08-03-2020 10:00:00,1,0,1,67,21,46,23,15,8,21,26
08-03-2020 11:00:00,1,0,1,55,16,39,20,14,6,33,39
08-03-2020 12:00:00,4,4,0,92,25,67,33,23,10,35,26
08-03-2020 13:00:00,2,1,1,107,56,51,30,19,11,28,33
08-03-2020 14:00:00,4,2,2,66,27,39,29,24,5,33,33
08-03-2020 15:00:00,7,4,3,57,28,29,29,18,11,23,41
08-03-2020 16:00:00,2,0,2,62,34,28,27,14,13,32,21
08-03-2020 17:00:00,2,1,1,69,32,37,28,18,10,29,27
08-03-2020 18:00:00,3,3,0,68,32,36,29,20,9,35,23
08-03-2020 19:00:00,3,1,2,75,38,37,30,17,13,31,12
08-03-2020 20:00:00,5,3,2,43,23,20,25,13,12,20,9
08-03-2020 21:00:00,3,0,3,46,24,22,10,3,7,14,2
08-03-2020 22:00:00,2,0,2,24,16,8,18,10,8,27,5
08-03-2020 23:00:00,0,0,0,21,13,8,10,3,7,18,8
09-03-2020 00:00:00,0,0,0,12,10,2,0,0,0,7,1
09-03-2020 01:00:00,1,1,0,4,2,2,0,0,0,2,4
09-03-2020 02:00:00,0,0,0,2,2,0,1,0,1,1,0
09-03-2020 03:00:00,0,0,0,2,0,2,4,3,1,2,1
09-03-2020 04:00:00,1,0,1,5,2,3,4,4,0,2,7
09-03-2020 05:00:00,1,0,1,30,4,26,12,11,1,5,22
09-03-2020 06:00:00,3,3,0,123,16,107,114,109,5,11,67
09-03-2020 07:00:00,12,10,2,359,42,317,185,168,17,31,196
09-03-2020 08:00:00,45,41,4,877,81,796,315,289,26,63,497
09-03-2020 09:00:00,23,21,2,354,41,313,151,137,14,27,197
09-03-2020 10:00:00,7,2,5,74,16,58,34,32,2,10,48
09-03-2020 11:00:00,3,2,1,48,16,32,27,22,5,9,34
09-03-2020 12:00:00,5,3,2,74,27,47,32,24,8,36,20
09-03-2020 13:00:00,4,2,2,81,35,46,40,24,16,45,23
09-03-2020 14:00:00,5,2,3,57,26,31,37,23,14,43,21
09-03-2020 15:00:00,0,0,0,92,60,32,39,17,22,37,22
09-03-2020 16:00:00,4,2,2,226,142,84,62,27,35,147,38
09-03-2020 17:00:00,13,2,11,483,408,75,166,65,101,411,69
09-03-2020 18:00:00,12,3,9,422,339,83,136,34,102,289,39
09-03-2020 19:00:00,7,5,2,191,142,49,58,25,33,141,15
09-03-2020 20:00:00,3,3,0,105,72,33,45,21,24,66,15
09-03-2020 21:00:00,5,4,1,67,48,19,34,17,17,42,7
09-03-2020 22:00:00,2,0,2,44,32,12,32,20,12,28,6
09-03-2020 23:00:00,0,0,0,24,20,4,13,1,12,17,3
10-03-2020 00:00:00,1,1,0,15,13,2,5,2,3,9,0
10-03-2020 01:00:00,0,0,0,3,3,0,1,1,0,0,0
10-03-2020 02:00:00,1,0,1,2,2,0,0,0,0,2,1
10-03-2020 03:00:00,1,0,1,1,0,1,2,2,0,2,2
10-03-2020 04:00:00,0,0,0,5,1,4,5,5,0,2,4
10-03-2020 05:00:00,1,0,1,30,6,24,19,17,2,4,14
10-03-2020 06:00:00,5,4,1,150,35,115,109,102,7,9,51
10-03-2020 07:00:00,19,16,3,412,54,358,171,158,13,31,152
10-03-2020 08:00:00,36,30,6,849,89,760,333,317,16,53,451
10-03-2020 09:00:00,10,10,0,325,34,291,170,154,16,22,195
10-03-2020 10:00:00,1,1,0,79,22,57,37,30,7,8,66
10-03-2020 11:00:00,4,3,1,84,23,61,28,23,5,5,30
10-03-2020 12:00:00,1,1,0,115,41,74,48,36,12,36,31
10-03-2020 13:00:00,6,2,4,111,48,63,44,35,9,39,38
10-03-2020 14:00:00,7,5,2,83,48,35,35,26,9,53,20
10-03-2020 15:00:00,8,5,3,113,58,55,49,21,28,72,35
10-03-2020 16:00:00,14,7,7,194,130,64,88,47,41,158,43
10-03-2020 17:00:00,17,5,12,529,399,130,180,61,119,331,65
10-03-2020 18:00:00,8,4,4,463,358,105,153,43,110,359,56
10-03-2020 19:00:00,7,1,6,234,167,67,71,30,41,148,24
10-03-2020 20:00:00,5,3,2,160,105,55,55,15,40,87,2
10-03-2020 21:00:00,5,1,4,92,67,25,18,8,10,52,9
10-03-2020 22:00:00,1,1,0,49,31,18,29,15,14,45,8
10-03-2020 23:00:00,2,1,1,37,23,14,16,4,12,14,4
11-03-2020 00:00:00,2,2,0,13,9,4,6,3,3,8,6
11-03-2020 01:00:00,0,0,0,6,4,2,1,1,0,1,0
11-03-2020 02:00:00,0,0,0,6,3,3,1,0,1,5,1
11-03-2020 03:00:00,2,0,2,1,0,1,2,2,0,4,2
11-03-2020 04:00:00,0,0,0,10,1,9,7,7,0,4,10
11-03-2020 05:00:00,1,0,1,33,5,28,19,16,3,8,16
11-03-2020 06:00:00,4,3,1,125,20,105,122,118,4,15,72
11-03-2020 07:00:00,16,13,3,402,41,361,184,163,21,32,226
11-03-2020 08:00:00,38,31,7,889,88,801,301,274,27,55,304
11-03-2020 09:00:00,15,12,3,357,39,318,149,137,12,30,200
11-03-2020 10:00:00,2,2,0,63,10,53,34,30,4,12,52
11-03-2020 11:00:00,2,1,1,81,25,56,29,24,5,15,34
11-03-2020 12:00:00,3,1,2,106,46,60,45,28,17,33,56
11-03-2020 13:00:00,6,3,3,95,48,47,47,32,15,37,47
11-03-2020 14:00:00,4,2,2,106,49,57,42,30,12,51,30
11-03-2020 15:00:00,4,4,0,111,61,50,39,13,26,67,28
11-03-2020 16:00:00,7,4,3,195,124,71,71,33,38,140,40
11-03-2020 17:00:00,10,4,6,473,386,87,145,62,83,361,56
11-03-2020 18:00:00,14,6,8,418,345,73,112,33,79,323,39
11-03-2020 19:00:00,5,3,2,160,124,36,68,29,39,140,20
11-03-2020 20:00:00,3,2,1,113,79,34,34,16,18,50,12
11-03-2020 21:00:00,2,1,1,58,44,14,23,6,17,44,8
11-03-2020 22:00:00,1,0,1,43,32,11,34,5,29,38,10
11-03-2020 23:00:00,0,0,0,25,19,6,7,2,5,19,5
12-03-2020 00:00:00,0,0,0,14,11,3,8,3,5,11,5
12-03-2020 01:00:00,0,0,0,5,4,1,0,0,0,3,0
12-03-2020 02:00:00,0,0,0,1,1,0,1,1,0,1,1
12-03-2020 03:00:00,1,0,1,4,3,1,2,2,0,4,2
12-03-2020 04:00:00,0,0,0,5,0,5,5,5,0,2,7
12-03-2020 05:00:00,0,0,0,24,5,19,14,13,1,3,16
12-03-2020 06:00:00,4,3,1,115,16,99,110,106,4,12,60
12-03-2020 07:00:00,16,14,2,346,47,299,127,119,8,28,161
12-03-2020 08:00:00,38,32,6,723,57,666,249,227,22,57,293
12-03-2020 09:00:00,17,17,0,286,22,264,139,119,20,26,196
12-03-2020 10:00:00,4,1,3,70,24,46,34,29,5,17,55
12-03-2020 11:00:00,1,0,1,58,15,43,27,20,7,15,24
12-03-2020 12:00:00,4,3,1,90,36,54,41,29,12,39,29
12-03-2020 13:00:00,7,4,3,94,39,55,37,28,9,53,34
12-03-2020 14:00:00,4,2,2,93,49,44,32,20,12,52,25
12-03-2020 15:00:00,7,4,3,120,66,54,46,18,28,57,27
12-03-2020 16:00:00,4,3,1,210,135,75,77,33,44,143,31
12-03-2020 17:00:00,12,3,9,409,319,90,118,48,70,307,51
12-03-2020 18:00:00,6,5,1,391,305,86,93,31,62,233,41
12-03-2020 19:00:00,6,4,2,168,125,43,55,26,29,112,20
12-03-2020 20:00:00,2,2,0,105,65,40,46,21,25,63,14
12-03-2020 21:00:00,1,0,1,46,32,14,25,7,18,41,6
12-03-2020 22:00:00,1,1,0,36,26,10,12,4,8,31,12
12-03-2020 23:00:00,4,2,2,22,15,7,5,2,3,16,6
13-03-2020 00:00:00,3,0,3,11,10,1,3,1,2,16,4
13-03-2020 01:00:00,0,0,0,9,8,1,1,1,0,7,0
13-03-2020 02:00:00,0,0,0,7,3,4,1,0,1,2,1
13-03-2020 03:00:00,1,1,0,4,3,1,1,1,0,2,2
13-03-2020 04:00:00,1,0,1,5,2,3,5,5,0,2,5
13-03-2020 05:00:00,1,0,1,27,4,23,15,14,1,4,13
13-03-2020 06:00:00,6,5,1,103,11,92,92,90,2,10,73
13-03-2020 07:00:00,7,5,2,221,41,180,79,72,7,26,124
13-03-2020 08:00:00,18,16,2,394,42,352,139,123,16,37,229
13-03-2020 09:00:00,7,4,3,176,30,146,102,89,13,27,122
13-03-2020 10:00:00,6,5,1,78,16,62,33,26,7,29,45
13-03-2020 11:00:00,6,5,1,80,23,57,32,23,9,21,34
13-03-2020 12:00:00,6,2,4,100,42,58,37,24,13,31,44
13-03-2020 13:00:00,6,5,1,125,43,82,43,24,19,66,45
13-03-2020 14:00:00,10,7,3,112,59,53,48,28,20,48,42
13-03-2020 15:00:00,3,2,1,128,77,51,33,14,19,69,28
13-03-2020 16:00:00,10,6,4,180,121,59,65,41,24,118,44
13-03-2020 17:00:00,8,3,5,250,182,68,99,43,56,190,53
13-03-2020 18:00:00,4,4,0,194,145,49,77,30,47,134,41
13-03-2020 19:00:00,3,2,1,123,70,53,38,18,20,60,22
13-03-2020 20:00:00,1,1,0,76,47,29,21,12,9,44,10
13-03-2020 21:00:00,3,2,1,49,35,14,19,6,13,24,6
13-03-2020 22:00:00,2,2,0,33,26,7,13,5,8,27,0
13-03-2020 23:00:00,2,1,1,33,24,9,7,2,5,20,4
14-03-2020 00:00:00,0,0,0,17,11,6,3,0,3,6,6
14-03-2020 01:00:00,1,0,1,16,12,4,4,1,3,8,2
14-03-2020 02:00:00,0,0,0,14,8,6,1,1,0,6,1
14-03-2020 03:00:00,0,0,0,8,5,3,0,0,0,5,2
14-03-2020 04:00:00,1,1,0,7,0,7,1,1,0,4,2
14-03-2020 05:00:00,0,0,0,18,5,13,7,7,0,2,5
14-03-2020 06:00:00,1,0,1,27,3,24,21,20,1,5,18
14-03-2020 07:00:00,0,0,0,42,8,34,40,38,2,6,25
14-03-2020 08:00:00,2,1,1,49,13,36,20,18,2,13,23
14-03-2020 09:00:00,4,3,1,62,19,43,24,23,1,18,25
14-03-2020 10:00:00,1,0,1,56,23,33,31,25,6,22,16
14-03-2020 11:00:00,2,0,2,65,19,46,30,15,15,36,26
14-03-2020 12:00:00,4,4,0,64,27,37,26,17,9,27,19
14-03-2020 13:00:00,7,4,3,74,36,38,29,19,10,22,11
14-03-2020 14:00:00,4,1,3,54,28,26,26,13,13,39,25
14-03-2020 15:00:00,1,1,0,64,37,27,24,15,9,31,27
14-03-2020 16:00:00,8,4,4,65,24,41,24,16,8,31,33
14-03-2020 17:00:00,5,4,1,67,34,33,33,21,12,36,25
14-03-2020 18:00:00,1,1,0,71,36,35,20,10,10,32,15
14-03-2020 19:00:00,2,0,2,58,27,31,27,20,7,29,12
14-03-2020 20:00:00,4,3,1,38,18,20,19,17,2,18,1
14-03-2020 21:00:00,0,0,0,27,20,7,11,7,4,15,1
14-03-2020 22:00:00,2,2,0,26,20,6,12,7,5,24,7
14-03-2020 23:00:00,2,2,0,28,19,9,10,1,9,13,4
15-03-2020 00:00:00,1,0,1,9,5,4,5,0,5,11,3
15-03-2020 01:00:00,0,0,0,12,11,1,2,2,0,3,1
15-03-2020 02:00:00,1,0,1,4,2,2,0,0,0,3,0
15-03-2020 03:00:00,1,1,0,5,3,2,0,0,0,3,0
15-03-2020 04:00:00,0,0,0,9,4,5,0,0,0,0,0
15-03-2020 05:00:00,1,0,1,10,1,9,5,5,0,0,8
15-03-2020 06:00:00,0,0,0,17,2,15,14,12,2,8,11
15-03-2020 07:00:00,1,1,0,23,4,19,20,20,0,5,24
15-03-2020 08:00:00,1,0,1,26,4,22,19,18,1,9,17
15-03-2020 09:00:00,1,1,0,37,7,30,9,9,0,8,11
15-03-2020 10:00:00,5,4,1,56,17,39,21,13,8,23,14
15-03-2020 11:00:00,6,5,1,67,30,37,24,16,8,29,24
15-03-2020 12:00:00,3,1,2,70,34,36,22,11,11,40,34
15-03-2020 13:00:00,6,5,1,83,45,38,26,18,8,43,39
15-03-2020 14:00:00,7,6,1,81,34,47,35,20,15,50,24
15-03-2020 15:00:00,7,6,1,70,25,45,36,18,18,42,27
15-03-2020 16:00:00,4,2,2,68,33,35,48,30,18,38,29
15-03-2020 17:00:00,6,4,2,95,46,49,37,20,17,47,33
15-03-2020 18:00:00,1,0,1,58,34,24,28,21,7,29,17
15-03-2020 19:00:00,2,2,0,45,26,19,18,10,8,13,8
15-03-2020 20:00:00,1,1,0,28,16,12,13,6,7,17,7
15-03-2020 21:00:00,2,0,2,31,18,13,9,6,3,18,6
15-03-2020 22:00:00,1,1,0,31,22,9,11,7,4,17,3
15-03-2020 23:00:00,1,0,1,13,8,5,4,4,0,10,4
16-03-2020 00:00:00,1,0,1,5,4,1,0,0,0,4,1
16-03-2020 01:00:00,0,0,0,6,4,2,0,0,0,1,1
16-03-2020 02:00:00,0,0,0,3,2,1,2,2,0,1,1
16-03-2020 03:00:00,0,0,0,4,0,4,4,3,1,0,1
16-03-2020 04:00:00,0,0,0,10,2,8,0,0,0,2,1
16-03-2020 05:00:00,0,0,0,16,2,14,13,12,1,1,13
16-03-2020 06:00:00,1,1,0,70,14,56,57,57,0,9,62
16-03-2020 07:00:00,7,5,2,166,35,131,70,62,8,24,113
16-03-2020 08:00:00,5,3,2,256,42,214,93,79,14,33,123
16-03-2020 09:00:00,9,7,2,116,25,91,54,44,10,18,84
16-03-2020 10:00:00,2,0,2,72,19,53,13,10,3,13,38
16-03-2020 11:00:00,6,5,1,64,23,41,31,24,7,36,34
16-03-2020 12:00:00,2,1,1,96,37,59,29,21,8,41,35
16-03-2020 13:00:00,7,3,4,85,44,41,29,21,8,46,20
16-03-2020 14:00:00,3,1,2,94,55,39,36,23,13,48,28
16-03-2020 15:00:00,4,1,3,90,66,24,34,13,21,56,31
16-03-2020 16:00:00,8,4,4,129,80,49,51,29,22,99,44
16-03-2020 17:00:00,5,2,3,171,111,60,61,25,36,153,47
16-03-2020 18:00:00,5,3,2,134,93,41,59,25,34,126,21
16-03-2020 19:00:00,5,3,2,85,57,28,26,12,14,48,10
16-03-2020 20:00:00,5,3,2,53,28,25,19,11,8,14,3
16-03-2020 21:00:00,6,2,4,25,19,6,11,7,4,9,1
16-03-2020 22:00:00,5,1,4,14,9,5,9,5,4,14,5
16-03-2020 23:00:00,0,0,0,10,7,3,5,1,4,12,3
17-03-2020 00:00:00,0,0,0,4,1,3,2,2,0,2,0
17-03-2020 01:00:00,0,0,0,2,1,1,0,0,0,0,1
17-03-2020 02:00:00,0,0,0,3,2,1,0,0,0,0,0
17-03-2020 03:00:00,0,0,0,2,1,1,0,0,0,1,1
17-03-2020 04:00:00,0,0,0,3,0,3,1,1,0,0,2
17-03-2020 05:00:00,0,0,0,16,1,15,2,1,1,2,3
17-03-2020 06:00:00,1,1,0,30,6,24,13,12,1,8,26
17-03-2020 07:00:00,4,4,0,27,5,22,21,16,5,8,21
17-03-2020 08:00:00,1,1,0,52,11,41,19,15,4,12,22
17-03-2020 09:00:00,1,1,0,37,17,20,16,11,5,20,23
17-03-2020 10:00:00,2,2,0,46,12,34,22,11,11,18,31
17-03-2020 11:00:00,6,3,3,58,25,33,21,15,6,44,26
17-03-2020 12:00:00,11,7,4,88,32,56,31,20,11,40,39
17-03-2020 13:00:00,3,3,0,69,38,31,26,20,6,39,36
17-03-2020 14:00:00,7,3,4,102,50,52,40,22,18,43,35
17-03-2020 15:00:00,6,2,4,103,47,56,24,10,14,42,30
17-03-2020 16:00:00,6,5,1,90,40,50,32,26,6,35,23
17-03-2020 17:00:00,8,5,3,75,41,34,34,14,20,37,31
17-03-2020 18:00:00,5,2,3,46,21,25,24,20,4,29,30
17-03-2020 19:00:00,4,2,2,32,18,14,15,9,6,17,12
17-03-2020 20:00:00,2,0,2,32,18,14,12,7,5,9,3
17-03-2020 21:00:00,1,1,0,16,11,5,13,8,5,12,8
17-03-2020 22:00:00,4,2,2,13,9,4,8,5,3,13,4
17-03-2020 23:00:00,3,3,0,14,7,7,11,2,9,7,3
18-03-2020 00:00:00,0,0,0,3,1,2,1,1,0,3,2
18-03-2020 01:00:00,0,0,0,4,3,1,0,0,0,2,4
18-03-2020 02:00:00,1,0,1,2,0,2,0,0,0,4,1
18-03-2020 03:00:00,0,0,0,3,2,1,2,2,0,1,1
18-03-2020 04:00:00,0,0,0,6,0,6,3,3,0,0,2
18-03-2020 05:00:00,1,0,1,20,6,14,8,7,1,3,6
18-03-2020 06:00:00,6,4,2,77,8,69,69,65,4,14,61
18-03-2020 07:00:00,6,4,2,147,32,115,59,49,10,17,125
18-03-2020 08:00:00,5,4,1,258,43,215,104,89,15,26,173
18-03-2020 09:00:00,7,7,0,132,29,103,46,39,7,23,80
18-03-2020 10:00:00,4,2,2,53,17,36,29,23,6,23,43
18-03-2020 11:00:00,0,0,0,68,27,41,27,17,10,19,34
18-03-2020 12:00:00,2,1,1,65,26,39,32,20,12,35,35
18-03-2020 13:00:00,4,2,2,86,38,48,30,19,11,48,40
18-03-2020 14:00:00,4,2,2,73,36,37,30,20,10,41,41
18-03-2020 15:00:00,4,2,2,87,52,35,31,17,14,57,28
18-03-2020 16:00:00,4,3,1,127,69,58,41,20,21,107,38
18-03-2020 17:00:00,11,3,8,197,136,61,70,37,33,199,51
18-03-2020 18:00:00,7,5,2,178,122,56,52,20,32,131,20
18-03-2020 19:00:00,3,1,2,85,44,41,21,8,13,44,14
18-03-2020 20:00:00,6,4,2,47,28,19,20,11,9,31,5
18-03-2020 21:00:00,3,1,2,36,25,11,4,2,2,21,10
18-03-2020 22:00:00,3,1,2,26,21,5,8,2,6,23,7
18-03-2020 23:00:00,0,0,0,11,7,4,6,2,4,10,1
19-03-2020 00:00:00,0,0,0,5,4,1,2,2,0,1,2
19-03-2020 01:00:00,0,0,0,2,1,1,1,1,0,2,1
19-03-2020 02:00:00,0,0,0,1,1,0,1,1,0,2,0
19-03-2020 03:00:00,0,0,0,2,2,0,0,0,0,1,1
19-03-2020 04:00:00,1,0,1,2,0,2,4,4,0,0,1
19-03-2020 05:00:00,0,0,0,19,4,15,6,6,0,2,7
19-03-2020 06:00:00,1,1,0,80,12,68,61,59,2,10,62
19-03-2020 07:00:00,7,7,0,162,28,134,73,64,9,18,124
19-03-2020 08:00:00,8,7,1,202,47,155,100,89,11,28,183
19-03-2020 09:00:00,4,4,0,122,37,85,27,21,6,15,77
19-03-2020 10:00:00,6,6,0,64,19,45,19,15,4,22,42
19-03-2020 11:00:00,2,2,0,75,19,56,33,24,9,21,30
19-03-2020 12:00:00,1,0,1,100,51,49,34,20,14,37,34
19-03-2020 13:00:00,7,1,6,98,37,61,32,22,10,68,33
19-03-2020 14:00:00,8,4,4,84,33,51,28,16,12,38,42
19-03-2020 15:00:00,1,0,1,97,48,49,36,21,15,73,33
19-03-2020 16:00:00,5,2,3,184,115,69,41,15,26,107,40
19-03-2020 17:00:00,4,2,2,187,113,74,59,29,30,171,49
19-03-2020 18:00:00,4,1,3,166,112,54,64,29,35,122,33
19-03-2020 19:00:00,3,1,2,104,55,49,25,15,10,43,7
19-03-2020 20:00:00,2,1,1,72,44,28,25,9,16,28,3
19-03-2020 21:00:00,1,1,0,42,24,18,10,4,6,23,12
19-03-2020 22:00:00,1,0,1,18,12,6,11,7,4,15,4
19-03-2020 23:00:00,0,0,0,9,6,3,5,1,4,12,2
20-03-2020 00:00:00,1,1,0,10,8,2,1,0,1,3,2
20-03-2020 01:00:00,0,0,0,6,1,5,2,2,0,1,0
20-03-2020 02:00:00,0,0,0,0,0,0,0,0,0,1,0
20-03-2020 03:00:00,1,1,0,2,2,0,1,1,0,0,2
20-03-2020 04:00:00,0,0,0,5,1,4,3,3,0,1,0
20-03-2020 05:00:00,1,0,1,19,3,16,8,8,0,3,9
20-03-2020 06:00:00,3,2,1,71,15,56,60,58,2,12,60
20-03-2020 07:00:00,5,3,2,134,31,103,59,53,6,20,89
20-03-2020 08:00:00,7,5,2,201,47,154,84,73,11,21,103
20-03-2020 09:00:00,7,7,0,94,29,65,37,31,6,16,71
20-03-2020 10:00:00,4,3,1,59,20,39,23,20,3,18,36
20-03-2020 11:00:00,5,3,2,80,29,51,26,17,9,28,36
20-03-2020 12:00:00,7,3,4,81,34,47,33,19,14,32,28
20-03-2020 13:00:00,6,2,4,117,57,60,39,24,15,56,40
20-03-2020 14:00:00,4,2,2,96,46,50,42,22,20,67,42
20-03-2020 15:00:00,7,2,5,109,59,50,42,21,21,64,47
20-03-2020 16:00:00,12,9,3,142,89,53,52,30,22,99,39
20-03-2020 17:00:00,6,4,2,193,121,72,54,26,28,149,50
20-03-2020 18:00:00,7,2,5,128,66,62,58,28,30,118,30
20-03-2020 19:00:00,2,0,2,82,50,32,21,10,11,51,18
20-03-2020 20:00:00,2,0,2,69,43,26,27,15,12,26,9
20-03-2020 21:00:00,0,0,0,33,20,13,17,11,6,18,15
20-03-2020 22:00:00,0,0,0,30,23,7,6,3,3,12,3
20-03-2020 23:00:00,5,1,4,14,6,8,9,4,5,9,4
21-03-2020 00:00:00,1,1,0,8,4,4,2,1,1,4,1
21-03-2020 01:00:00,1,1,0,5,4,1,1,0,1,2,2
21-03-2020 02:00:00,1,0,1,4,1,3,0,0,0,1,0
21-03-2020 03:00:00,0,0,0,3,2,1,0,0,0,1,0
21-03-2020 04:00:00,0,0,0,6,2,4,1,1,0,1,1
21-03-2020 05:00:00,0,0,0,11,2,9,2,2,0,1,2
21-03-2020 06:00:00,0,0,0,25,5,20,7,6,1,9,10
21-03-2020 07:00:00,1,1,0,39,7,32,20,18,2,12,26
21-03-2020 08:00:00,4,3,1,36,13,23,25,16,9,15,23
21-03-2020 09:00:00,0,0,0,53,19,34,20,14,6,15,28
21-03-2020 10:00:00,4,3,1,49,20,29,20,12,8,38,28
21-03-2020 11:00:00,3,1,2,62,21,41,28,19,9,25,21
21-03-2020 12:00:00,2,0,2,59,27,32,40,20,20,34,37
21-03-2020 13:00:00,5,0,5,87,38,49,42,23,19,51,37
21-03-2020 14:00:00,12,8,4,85,39,46,40,23,17,37,41
21-03-2020 15:00:00,4,3,1,105,41,64,35,19,16,42,35
21-03-2020 16:00:00,10,4,6,87,40,47,39,17,22,55,36
21-03-2020 17:00:00,3,2,1,72,33,39,24,12,12,44,24
21-03-2020 18:00:00,3,2,1,67,29,38,28,22,6,42,25
21-03-2020 19:00:00,2,0,2,52,29,23,15,7,8,25,13
21-03-2020 20:00:00,0,0,0,45,24,21,15,9,6,16,6
21-03-2020 21:00:00,4,2,2,40,25,15,19,15,4,10,9
21-03-2020 22:00:00,0,0,0,25,17,8,8,4,4,18,7
21-03-2020 23:00:00,0,0,0,11,7,4,4,3,1,14,3
22-03-2020 00:00:00,1,0,1,5,3,2,4,3,1,3,7
22-03-2020 01:00:00,0,0,0,2,2,0,0,0,0,2,2
22-03-2020 02:00:00,0,0,0,2,1,1,0,0,0,2,2
22-03-2020 03:00:00,0,0,0,4,2,2,1,0,1,1,1
22-03-2020 04:00:00,0,0,0,4,2,2,0,0,0,0,0
22-03-2020 05:00:00,0,0,0,5,0,5,6,6,0,0,7
22-03-2020 06:00:00,0,0,0,18,5,13,4,3,1,2,10
22-03-2020 07:00:00,0,0,0,22,9,13,12,10,2,9,8
22-03-2020 08:00:00,2,1,1,35,13,22,6,4,2,7,22
22-03-2020 09:00:00,4,3,1,59,22,37,14,11,3,19,16
22-03-2020 10:00:00,7,4,3,76,32,44,23,19,4,40,26
22-03-2020 11:00:00,4,3,1,98,25,73,41,20,21,40,25
22-03-2020 12:00:00,6,4,2,105,42,63,57,34,23,76,29
22-03-2020 13:00:00,9,5,4,131,59,72,56,31,25,73,36
22-03-2020 14:00:00,5,2,3,158,77,81,59,28,31,79,50
22-03-2020 15:00:00,12,6,6,128,55,73,62,29,33,68,61
22-03-2020 16:00:00,12,8,4,108,49,59,49,28,21,41,73
22-03-2020 17:00:00,16,8,8,77,41,36,40,26,14,44,51
22-03-2020 18:00:00,1,1,0,79,49,30,22,13,9,32,33
22-03-2020 19:00:00,1,0,1,66,45,21,23,16,7,27,9
22-03-2020 20:00:00,2,2,0,47,27,20,18,10,8,18,15
22-03-2020 21:00:00,1,0,1,34,19,15,17,6,11,15,5
22-03-2020 22:00:00,0,0,0,12,10,2,7,5,2,8,7
22-03-2020 23:00:00,1,0,1,6,3,3,4,2,2,9,2
23-03-2020 00:00:00,0,0,0,1,1,0,0,0,0,3,2
23-03-2020 01:00:00,0,0,0,5,2,3,0,0,0,1,1
23-03-2020 02:00:00,0,0,0,2,1,1,1,1,0,0,0
23-03-2020 03:00:00,0,0,0,3,2,1,1,1,0,0,0
23-03-2020 04:00:00,0,0,0,3,1,2,2,2,0,0,1
23-03-2020 05:00:00,0,0,0,15,1,14,8,8,0,4,10
23-03-2020 06:00:00,1,1,0,83,19,64,59,56,3,6,59
23-03-2020 07:00:00,4,2,2,141,33,108,73,64,9,17,116
23-03-2020 08:00:00,6,3,3,212,46,166,63,58,5,24,132
23-03-2020 09:00:00,7,5,2,106,28,78,31,24,7,20,78
23-03-2020 10:00:00,1,1,0,47,16,31,26,13,13,18,25
23-03-2020 11:00:00,5,3,2,51,19,32,22,17,5,25,32
23-03-2020 12:00:00,8,5,3,84,41,43,26,22,4,35,34
23-03-2020 13:00:00,1,1,0,94,45,49,34,19,15,53,41
23-03-2020 14:00:00,9,6,3,91,44,47,28,16,12,59,37
23-03-2020 15:00:00,5,5,0,98,60,38,36,20,16,61,39
23-03-2020 16:00:00,6,2,4,117,67,50,52,26,26,105,40
23-03-2020 17:00:00,8,4,4,174,107,67,49,29,20,160,34
23-03-2020 18:00:00,4,2,2,152,95,57,60,25,35,100,30
23-03-2020 19:00:00,2,1,1,101,43,58,27,13,14,39,22
23-03-2020 20:00:00,3,3,0,42,20,22,23,11,12,27,10
23-03-2020 21:00:00,3,2,1,29,24,5,19,12,7,19,11
23-03-2020 22:00:00,0,0,0,19,17,2,8,6,2,14,5
23-03-2020 23:00:00,0,0,0,9,6,3,6,5,1,6,0
24-03-2020 00:00:00,2,0,2,3,3,0,1,0,1,3,2
24-03-2020 01:00:00,0,0,0,1,0,1,0,0,0,2,1
24-03-2020 02:00:00,0,0,0,1,1,0,0,0,0,1,0
24-03-2020 03:00:00,0,0,0,4,3,1,1,1,0,0,0
24-03-2020 04:00:00,0,0,0,5,1,4,2,2,0,2,4
24-03-2020 05:00:00,0,0,0,20,5,15,6,6,0,2,9
24-03-2020 06:00:00,3,3,0,61,10,51,64,63,1,13,53
24-03-2020 07:00:00,5,3,2,150,32,118,67,56,11,24,93
24-03-2020 08:00:00,3,3,0,196,48,148,65,57,8,24,114
24-03-2020 09:00:00,6,3,3,89,25,64,27,23,4,13,66
24-03-2020 10:00:00,3,2,1,45,16,29,25,19,6,24,34
24-03-2020 11:00:00,3,2,1,69,25,44,18,13,5,25,28
24-03-2020 12:00:00,2,1,1,82,36,46,25,18,7,41,26
24-03-2020 13:00:00,7,5,2,84,42,42,40,22,18,49,32
24-03-2020 14:00:00,4,2,2,80,39,41,32,17,15,51,38
24-03-2020 15:00:00,6,5,1,88,47,41,36,22,14,70,31
24-03-2020 16:00:00,3,2,1,121,71,50,50,27,23,99,41
24-03-2020 17:00:00,7,5,2,201,113,88,56,30,26,135,38
24-03-2020 18:00:00,2,2,0,162,95,67,45,25,20,111,52
24-03-2020 19:00:00,9,7,2,74,37,37,27,17,10,34,18
24-03-2020 20:00:00,1,0,1,70,42,28,25,12,13,26,9
24-03-2020 21:00:00,11,2,9,29,20,9,14,10,4,20,11
24-03-2020 22:00:00,6,4,2,16,11,5,3,3,0,13,5
24-03-2020 23:00:00,1,1,0,6,3,3,3,3,0,8,2
25-03-2020 00:00:00,0,0,0,2,1,1,0,0,0,4,2
25-03-2020 01:00:00,0,0,0,1,1,0,0,0,0,1,0
25-03-2020 02:00:00,0,0,0,1,0,1,0,0,0,2,0
25-03-2020 03:00:00,0,0,0,4,3,1,2,2,0,1,1
25-03-2020 04:00:00,1,1,0,7,2,5,4,4,0,1,4
25-03-2020 05:00:00,0,0,0,22,6,16,6,5,1,4,12
25-03-2020 06:00:00,2,2,0,73,14,59,65,61,4,18,54
25-03-2020 07:00:00,6,5,1,142,35,107,66,58,8,16,99
25-03-2020 08:00:00,6,5,1,163,43,120,62,53,9,25,119
25-03-2020 09:00:00,6,5,1,104,24,80,33,30,3,22,58
25-03-2020 10:00:00,3,2,1,65,25,40,19,13,6,21,30
25-03-2020 11:00:00,4,4,0,65,25,40,22,16,6,27,37
25-03-2020 12:00:00,3,2,1,102,40,62,30,14,16,39,29
25-03-2020 13:00:00,6,2,4,120,55,65,45,32,13,50,64
25-03-2020 14:00:00,6,4,2,110,52,58,39,20,19,54,41
25-03-2020 15:00:00,5,3,2,118,60,58,42,14,28,65,28
25-03-2020 16:00:00,8,3,5,156,92,64,50,32,18,103,27
25-03-2020 17:00:00,9,3,6,207,120,87,69,37,32,139,60
25-03-2020 18:00:00,7,2,5,163,87,76,56,26,30,93,40
25-03-2020 19:00:00,2,0,2,82,39,43,40,17,23,35,12
25-03-2020 20:00:00,3,2,1,50,32,18,29,19,10,31,7
25-03-2020 21:00:00,0,0,0,37,24,13,12,8,4,17,5
25-03-2020 22:00:00,3,1,2,22,15,7,6,3,3,9,7
25-03-2020 23:00:00,2,1,1,6,4,2,1,1,0,4,1
26-03-2020 00:00:00,0,0,0,3,1,2,1,0,1,4,2
26-03-2020 01:00:00,0,0,0,3,2,1,0,0,0,1,0
26-03-2020 02:00:00,1,0,1,1,0,1,0,0,0,0,0
26-03-2020 03:00:00,0,0,0,2,2,0,1,1,0,0,1
26-03-2020 04:00:00,0,0,0,9,3,6,2,2,0,0,4
26-03-2020 05:00:00,0,0,0,17,3,14,6,6,0,3,12
26-03-2020 06:00:00,3,3,0,71,15,56,60,58,2,16,54
26-03-2020 07:00:00,3,2,1,126,30,96,65,55,10,20,97
26-03-2020 08:00:00,3,2,1,169,50,119,49,43,6,22,104
26-03-2020 09:00:00,1,1,0,78,23,55,37,30,7,11,42
26-03-2020 10:00:00,3,2,1,68,24,44,18,13,5,27,31
26-03-2020 11:00:00,3,3,0,54,19,35,17,9,8,25,18
26-03-2020 12:00:00,0,0,0,84,39,45,34,28,6,37,30
26-03-2020 13:00:00,4,3,1,95,50,45,40,27,13,47,24
26-03-2020 14:00:00,8,5,3,108,56,52,28,13,15,39,30
26-03-2020 15:00:00,4,4,0,126,68,58,35,19,16,64,24
26-03-2020 16:00:00,5,3,2,150,80,70,55,37,18,100,44
26-03-2020 17:00:00,5,3,2,206,112,94,45,31,14,126,45
26-03-2020 18:00:00,6,3,3,164,86,78,48,25,23,80,37
26-03-2020 19:00:00,0,0,0,95,50,45,39,20,19,38,23
26-03-2020 20:00:00,3,2,1,49,31,18,21,13,8,28,15
26-03-2020 21:00:00,2,1,1,40,25,15,10,5,5,21,13
26-03-2020 22:00:00,1,1,0,26,16,10,6,4,2,11,6
26-03-2020 23:00:00,0,0,0,6,4,2,2,1,1,6,1
27-03-2020 00:00:00,0,0,0,0,0,0,0,0,0,3,0
27-03-2020 01:00:00,0,0,0,1,1,0,0,0,0,1,0
27-03-2020 02:00:00,0,0,0,2,1,1,1,0,1,3,0
27-03-2020 03:00:00,0,0,0,3,3,0,1,1,0,0,0
27-03-2020 04:00:00,1,1,0,5,3,2,0,0,0,1,0
27-03-2020 05:00:00,0,0,0,16,3,13,8,7,1,4,15
27-03-2020 06:00:00,4,4,0,67,10,57,55,54,1,10,51
27-03-2020 07:00:00,2,2,0,120,27,93,50,46,4,21,78
27-03-2020 08:00:00,3,2,1,152,34,118,47,42,5,20,98
27-03-2020 09:00:00,4,3,1,86,28,58,29,27,2,17,58
27-03-2020 10:00:00,5,2,3,49,14,35,17,14,3,7,25
27-03-2020 11:00:00,0,0,0,85,43,42,23,16,7,26,22
27-03-2020 12:00:00,3,1,2,72,33,39,23,16,7,36,34
27-03-2020 13:00:00,3,1,2,84,44,40,36,24,12,48,50
27-03-2020 14:00:00,6,3,3,107,53,54,29,20,9,55,23
27-03-2020 15:00:00,3,2,1,90,46,44,27,13,14,65,38
27-03-2020 16:00:00,9,4,5,112,62,50,51,31,20,74,24
27-03-2020 17:00:00,6,4,2,138,85,53,60,32,28,124,43
27-03-2020 18:00:00,5,3,2,136,82,54,35,21,14,80,48
27-03-2020 19:00:00,3,1,2,96,40,56,21,11,10,38,26
27-03-2020 20:00:00,2,1,1,66,37,29,21,12,9,30,17
27-03-2020 21:00:00,1,1,0,51,28,23,28,14,14,18,15
27-03-2020 22:00:00,1,1,0,42,25,17,25,17,8,17,12
27-03-2020 23:00:00,1,0,1,18,12,6,3,0,3,8,3
28-03-2020 00:00:00,1,1,0,5,3,2,0,0,0,3,3
28-03-2020 01:00:00,0,0,0,3,2,1,0,0,0,4,0
28-03-2020 02:00:00,0,0,0,1,1,0,0,0,0,2,0
28-03-2020 03:00:00,0,0,0,5,4,1,0,0,0,0,0
28-03-2020 04:00:00,0,0,0,4,1,3,1,1,0,0,1
28-03-2020 05:00:00,0,0,0,7,1,6,4,3,1,1,0
28-03-2020 06:00:00,1,1,0,16,6,10,10,9,1,3,13
28-03-2020 07:00:00,0,0,0,34,12,22,19,16,3,7,18
28-03-2020 08:00:00,1,1,0,24,7,17,6,6,0,8,18
28-03-2020 09:00:00,1,0,1,44,16,28,7,5,2,5,10
28-03-2020 10:00:00,1,0,1,25,9,16,8,5,3,13,5
28-03-2020 11:00:00,4,3,1,42,12,30,13,10,3,12,9
28-03-2020 12:00:00,2,1,1,28,14,14,12,8,4,16,15
28-03-2020 13:00:00,3,3,0,49,25,24,10,5,5,21,14
28-03-2020 14:00:00,3,2,1,44,19,25,26,21,5,24,13
28-03-2020 15:00:00,4,3,1,31,11,20,13,10,3,29,16
28-03-2020 16:00:00,4,2,2,46,25,21,16,10,6,26,21
28-03-2020 17:00:00,3,1,2,47,24,23,18,13,5,16,23
28-03-2020 18:00:00,8,3,5,58,27,31,25,14,11,27,30
28-03-2020 19:00:00,4,3,1,62,29,33,23,15,8,36,7
28-03-2020 20:00:00,4,4,0,49,29,20,14,9,5,12,8
28-03-2020 21:00:00,0,0,0,33,19,14,7,4,3,9,9
28-03-2020 22:00:00,1,0,1,19,13,6,11,8,3,17,4
28-03-2020 23:00:00,1,1,0,6,3,3,4,0,4,9,2
29-03-2020 00:00:00,0,0,0,5,4,1,2,0,2,2,1
29-03-2020 01:00:00,,,,,,,,,,,
29-03-2020 02:00:00,0,0,0,0,0,0,0,0,0,2,0
29-03-2020 03:00:00,0,0,0,0,0,0,1,1,0,0,0
29-03-2020 04:00:00,0,0,0,3,2,1,0,0,0,0,1
29-03-2020 05:00:00,0,0,0,4,1,3,2,2,0,1,0
29-03-2020 06:00:00,0,0,0,13,4,9,2,2,0,3,5
29-03-2020 07:00:00,2,0,2,18,5,13,7,6,1,4,8
29-03-2020 08:00:00,0,0,0,18,5,13,5,4,1,4,6
29-03-2020 09:00:00,1,0,1,17,5,12,4,4,0,3,10
29-03-2020 10:00:00,0,0,0,24,9,15,3,2,1,8,11
29-03-2020 11:00:00,0,0,0,36,15,21,7,6,1,8,11
29-03-2020 12:00:00,2,1,1,37,14,23,4,3,1,10,7
29-03-2020 13:00:00,2,1,1,36,26,10,23,16,7,11,6
29-03-2020 14:00:00,4,2,2,40,13,27,19,13,6,11,7
29-03-2020 15:00:00,5,3,2,39,14,25,19,14,5,18,11
29-03-2020 16:00:00,5,4,1,49,23,26,13,11,2,23,8
29-03-2020 17:00:00,0,0,0,66,31,35,23,18,5,14,19
29-03-2020 18:00:00,5,3,2,61,23,38,22,14,8,34,25
29-03-2020 19:00:00,2,1,1,60,30,30,19,13,6,23,26
29-03-2020 20:00:00,2,1,1,47,27,20,13,8,5,18,5
29-03-2020 21:00:00,0,0,0,25,14,11,10,8,2,11,7
29-03-2020 22:00:00,2,1,1,12,10,2,6,4,2,5,4
29-03-2020 23:00:00,0,0,0,8,3,5,2,0,2,4,0
30-03-2020 00:00:00,0,0,0,3,3,0,0,0,0,6,2
30-03-2020 01:00:00,0,0,0,1,1,0,0,0,0,0,0
30-03-2020 02:00:00,0,0,0,1,1,0,0,0,0,0,0
30-03-2020 03:00:00,0,0,0,2,2,0,1,1,0,1,0
30-03-2020 04:00:00,0,0,0,4,1,3,1,1,0,0,2
30-03-2020 05:00:00,1,0,1,16,4,12,4,4,0,2,6
30-03-2020 06:00:00,1,1,0,25,8,17,12,10,2,8,28
30-03-2020 07:00:00,2,1,1,82,33,49,36,30,6,11,50
30-03-2020 08:00:00,3,1,2,92,27,65,40,38,2,12,59
30-03-2020 09:00:00,3,1,2,53,21,32,17,14,3,11,42
30-03-2020 10:00:00,0,0,0,31,12,19,11,7,4,14,9
30-03-2020 11:00:00,1,1,0,38,12,26,4,3,1,14,17
30-03-2020 12:00:00,2,1,1,44,24,20,13,11,2,28,24
30-03-2020 13:00:00,4,0,4,57,25,32,19,10,9,27,17
30-03-2020 14:00:00,0,0,0,42,26,16,15,10,5,27,20
30-03-2020 15:00:00,5,4,1,63,27,36,11,8,3,27,24
30-03-2020 16:00:00,6,2,4,67,32,35,26,15,11,47,15
30-03-2020 17:00:00,2,1,1,98,58,40,40,20,20,51,19
30-03-2020 18:00:00,5,4,1,81,41,40,32,19,13,44,9
30-03-2020 19:00:00,3,2,1,54,24,30,15,11,4,30,17
30-03-2020 20:00:00,4,1,3,53,25,28,19,14,5,14,15
30-03-2020 21:00:00,0,0,0,30,18,12,7,3,4,11,9
30-03-2020 22:00:00,3,2,1,13,10,3,6,3,3,10,4
30-03-2020 23:00:00,1,0,1,6,4,2,2,0,2,6,1
31-03-2020 00:00:00,1,1,0,2,1,1,1,1,0,2,3
31-03-2020 01:00:00,0,0,0,1,0,1,1,0,1,1,0
31-03-2020 02:00:00,0,0,0,1,0,1,1,0,1,0,0
31-03-2020 03:00:00,0,0,0,0,0,0,1,1,0,0,0
31-03-2020 04:00:00,0,0,0,7,4,3,1,1,0,2,2
31-03-2020 05:00:00,0,0,0,9,3,6,3,3,0,1,3
31-03-2020 06:00:00,1,1,0,31,10,21,12,12,0,8,20
31-03-2020 07:00:00,3,2,1,67,19,48,31,25,6,11,52
31-03-2020 08:00:00,2,1,1,97,32,65,32,28,4,17,54
31-03-2020 09:00:00,0,0,0,51,21,30,9,6,3,11,31
31-03-2020 10:00:00,3,1,2,43,19,24,5,5,0,6,15
31-03-2020 11:00:00,2,1,1,33,14,19,10,7,3,11,13
31-03-2020 12:00:00,2,1,1,55,28,27,12,9,3,25,23
31-03-2020 13:00:00,0,0,0,66,32,34,16,10,6,20,22
31-03-2020 14:00:00,4,4,0,46,21,25,20,13,7,25,16
31-03-2020 15:00:00,0,0,0,43,21,22,22,18,4,24,17
31-03-2020 16:00:00,6,3,3,95,44,51,26,16,10,49,22
31-03-2020 17:00:00,7,5,2,118,60,58,38,25,13,59,31
31-03-2020 18:00:00,5,2,3,107,50,57,27,20,7,52,30
31-03-2020 19:00:00,6,1,5,75,37,38,23,16,7,34,16
31-03-2020 20:00:00,2,1,1,58,27,31,14,7,7,25,9
31-03-2020 21:00:00,7,5,2,30,15,15,12,6,6,22,10
31-03-2020 22:00:00,2,1,1,17,9,8,3,1,2,14,7
31-03-2020 23:00:00,0,0,0,7,5,2,3,1,2,6,0
01-04-2020 00:00:00,0,0,0,4,2,2,1,0,1,3,2
01-04-2020 01:00:00,0,0,0,2,1,1,0,0,0,0,1
01-04-2020 02:00:00,0,0,0,0,0,0,1,0,1,0,1
01-04-2020 03:00:00,0,0,0,4,4,0,1,1,0,1,0
01-04-2020 04:00:00,1,0,1,7,2,5,1,1,0,1,5
01-04-2020 05:00:00,0,0,0,7,2,5,4,4,0,3,5
01-04-2020 06:00:00,2,1,1,31,11,20,9,8,1,10,18
01-04-2020 07:00:00,1,0,1,61,24,37,28,24,4,11,41
01-04-2020 08:00:00,4,2,2,113,41,72,33,28,5,14,57
01-04-2020 09:00:00,3,3,0,48,19,29,8,8,0,9,28
01-04-2020 10:00:00,0,0,0,32,10,22,5,2,3,6,10
01-04-2020 11:00:00,2,1,1,31,12,19,8,5,3,14,21
01-04-2020 12:00:00,2,0,2,55,27,28,13,9,4,17,13
01-04-2020 13:00:00,5,3,2,54,29,25,24,12,12,28,23
01-04-2020 14:00:00,2,2,0,54,23,31,21,12,9,32,21
01-04-2020 15:00:00,4,3,1,66,30,36,16,12,4,31,9
01-04-2020 16:00:00,5,1,4,87,44,43,31,19,12,44,25
01-04-2020 17:00:00,4,3,1,113,60,53,29,25,4,54,23
01-04-2020 18:00:00,9,6,3,109,48,61,34,22,12,47,27
01-04-2020 19:00:00,5,3,2,85,34,51,27,21,6,21,18
01-04-2020 20:00:00,3,3,0,50,22,28,7,4,3,23,2
01-04-2020 21:00:00,3,2,1,29,20,9,11,7,4,14,7
01-04-2020 22:00:00,2,1,1,15,12,3,7,4,3,14,8
01-04-2020 23:00:00,0,0,0,7,2,5,2,2,0,5,2
02-04-2020 00:00:00,0,0,0,11,5,6,0,0,0,7,2
02-04-2020 01:00:00,0,0,0,1,0,1,0,0,0,0,1
02-04-2020 02:00:00,0,0,0,3,2,1,0,0,0,1,1
02-04-2020 03:00:00,0,0,0,2,2,0,0,0,0,0,0
02-04-2020 04:00:00,0,0,0,5,2,3,2,2,0,0,3
02-04-2020 05:00:00,0,0,0,8,3,5,4,4,0,1,2
02-04-2020 06:00:00,1,1,0,30,9,21,17,13,4,8,18
02-04-2020 07:00:00,0,0,0,77,31,46,27,25,2,5,45
02-04-2020 08:00:00,4,3,1,92,27,65,31,28,3,19,54
02-04-2020 09:00:00,1,0,1,47,13,34,12,10,2,6,26
02-04-2020 10:00:00,2,1,1,39,16,23,3,3,0,11,15
02-04-2020 11:00:00,1,1,0,26,8,18,9,5,4,14,13
02-04-2020 12:00:00,1,1,0,42,21,21,15,8,7,7,12
02-04-2020 13:00:00,2,0,2,48,27,21,27,18,9,28,15
02-04-2020 14:00:00,4,3,1,47,24,23,28,14,14,38,12
02-04-2020 15:00:00,5,4,1,65,31,34,10,6,4,31,12
02-04-2020 16:00:00,5,4,1,84,41,43,22,13,9,35,13
02-04-2020 17:00:00,7,5,2,113,57,56,34,21,13,44,26
02-04-2020 18:00:00,9,5,4,103,56,47,29,16,13,41,21
02-04-2020 19:00:00,3,2,1,77,41,36,39,29,10,40,14
02-04-2020 20:00:00,2,0,2,52,28,24,16,7,9,22,18
02-04-2020 21:00:00,0,0,0,29,14,15,21,15,6,19,14
02-04-2020 22:00:00,3,2,1,14,10,4,5,2,3,9,3
02-04-2020 23:00:00,0,0,0,5,4,1,1,0,1,5,1
03-04-2020 00:00:00,0,0,0,3,0,3,1,1,0,3,0
03-04-2020 01:00:00,0,0,0,7,5,2,0,0,0,2,1
03-04-2020 02:00:00,0,0,0,2,1,1,1,0,1,0,0
03-04-2020 03:00:00,0,0,0,3,3,0,1,1,0,0,0
03-04-2020 04:00:00,0,0,0,6,2,4,0,0,0,1,3
03-04-2020 05:00:00,0,0,0,6,3,3,2,2,0,3,6
03-04-2020 06:00:00,0,0,0,30,9,21,13,13,0,5,25
03-04-2020 07:00:00,1,0,1,67,24,43,29,23,6,6,48
03-04-2020 08:00:00,2,1,1,97,35,62,28,26,2,14,50
03-04-2020 09:00:00,3,1,2,61,21,40,10,10,0,9,24
03-04-2020 10:00:00,2,1,1,47,24,23,13,11,2,9,20
03-04-2020 11:00:00,3,2,1,49,22,27,20,16,4,21,9
03-04-2020 12:00:00,2,0,2,61,23,38,19,11,8,16,25
03-04-2020 13:00:00,5,1,4,85,34,51,23,17,6,41,30
03-04-2020 14:00:00,7,4,3,64,33,31,27,20,7,32,23
03-04-2020 15:00:00,2,2,0,61,27,34,16,11,5,34,20
03-04-2020 16:00:00,2,1,1,71,36,35,32,18,14,40,15
03-04-2020 17:00:00,5,5,0,91,43,48,45,30,15,54,27
03-04-2020 18:00:00,7,6,1,110,60,50,37,25,12,60,36
03-04-2020 19:00:00,4,0,4,85,42,43,18,15,3,28,29
03-04-2020 20:00:00,4,3,1,74,40,34,21,14,7,26,15
03-04-2020 21:00:00,2,1,1,54,29,25,18,13,5,22,15
03-04-2020 22:00:00,1,0,1,22,13,9,15,9,6,13,11
03-04-2020 23:00:00,0,0,0,12,7,5,4,1,3,9,1
04-04-2020 00:00:00,0,0,0,5,4,1,0,0,0,2,1
04-04-2020 01:00:00,2,1,1,1,1,0,1,1,0,1,1
04-04-2020 02:00:00,0,0,0,0,0,0,1,0,1,0,1
04-04-2020 03:00:00,0,0,0,3,3,0,0,0,0,0,0
04-04-2020 04:00:00,0,0,0,4,2,2,1,1,0,0,1
04-04-2020 05:00:00,0,0,0,8,2,6,3,3,0,3,4
04-04-2020 06:00:00,2,0,2,22,8,14,8,8,0,3,6
04-04-2020 07:00:00,0,0,0,30,17,13,15,13,2,9,13
04-04-2020 08:00:00,0,0,0,25,13,12,8,8,0,12,15
04-04-2020 09:00:00,5,2,3,28,10,18,16,11,5,11,25
04-04-2020 10:00:00,0,0,0,41,15,26,11,9,2,12,16
04-04-2020 11:00:00,3,1,2,52,18,34,7,2,5,30,22
04-04-2020 12:00:00,4,2,2,70,33,37,17,10,7,18,29
04-04-2020 13:00:00,7,3,4,93,50,43,29,22,7,28,26
04-04-2020 14:00:00,6,4,2,78,44,34,34,26,8,36,20
04-04-2020 15:00:00,1,1,0,87,34,53,11,9,2,31,27
04-04-2020 16:00:00,5,3,2,95,47,48,21,11,10,38,27
04-04-2020 17:00:00,2,1,1,81,38,43,27,17,10,37,25
04-04-2020 18:00:00,8,6,2,97,43,54,35,26,9,31,34
04-04-2020 19:00:00,0,0,0,66,36,30,37,22,15,33,25
04-04-2020 20:00:00,2,2,0,70,31,39,18,10,8,20,17
04-04-2020 21:00:00,1,1,0,51,28,23,11,6,5,12,5
04-04-2020 22:00:00,0,0,0,25,15,10,7,4,3,15,8
04-04-2020 23:00:00,0,0,0,12,6,6,6,2,4,3,2
05-04-2020 00:00:00,0,0,0,5,3,2,1,0,1,3,3
05-04-2020 01:00:00,0,0,0,0,0,0,0,0,0,0,0
05-04-2020 02:00:00,0,0,0,3,2,1,1,1,0,1,0
05-04-2020 03:00:00,0,0,0,0,0,0,0,0,0,0,0
05-04-2020 04:00:00,0,0,0,0,0,0,0,0,0,0,3
05-04-2020 05:00:00,0,0,0,4,0,4,1,1,0,1,1
05-04-2020 06:00:00,4,2,2,16,6,10,8,7,1,2,7
05-04-2020 07:00:00,0,0,0,19,6,13,7,6,1,5,6
05-04-2020 08:00:00,0,0,0,23,11,12,13,12,1,6,10
05-04-2020 09:00:00,2,1,1,36,20,16,8,6,2,5,8
05-04-2020 10:00:00,1,1,0,41,21,20,4,3,1,9,12
05-04-2020 11:00:00,6,4,2,66,23,43,12,9,3,11,24
05-04-2020 12:00:00,5,4,1,86,35,51,28,16,12,40,15
05-04-2020 13:00:00,4,2,2,95,55,40,21,16,5,25,17
05-04-2020 14:00:00,11,5,6,78,32,46,20,10,10,20,23
05-04-2020 15:00:00,7,4,3,81,32,49,15,6,9,27,20
05-04-2020 16:00:00,7,6,1,66,31,35,20,11,9,20,18
05-04-2020 17:00:00,3,2,1,72,37,35,17,14,3,15,11
05-04-2020 18:00:00,5,3,2,53,31,22,14,11,3,21,13
05-04-2020 19:00:00,2,2,0,45,25,20,19,13,6,22,10
05-04-2020 20:00:00,0,0,0,44,30,14,10,4,6,11,9
05-04-2020 21:00:00,3,3,0,32,14,18,8,6,2,8,9
05-04-2020 22:00:00,1,0,1,11,5,6,5,3,2,2,6
05-04-2020 23:00:00,0,0,0,8,6,2,4,1,3,4,3
06-04-2020 00:00:00,0,0,0,2,0,2,1,0,1,2,0
06-04-2020 01:00:00,0,0,0,0,0,0,0,0,0,1,1
06-04-2020 02:00:00,0,0,0,1,1,0,0,0,0,0,0
06-04-2020 03:00:00,0,0,0,6,5,1,0,0,0,1,2
06-04-2020 04:00:00,0,0,0,6,1,5,2,2,0,0,3
06-04-2020 05:00:00,1,0,1,10,3,7,2,2,0,0,3
06-04-2020 06:00:00,1,0,1,34,14,20,11,11,0,5,24
06-04-2020 07:00:00,4,2,2,80,34,46,27,25,2,10,46
06-04-2020 08:00:00,5,3,2,99,33,66,41,37,4,15,57
06-04-2020 09:00:00,4,2,2,49,15,34,12,7,5,4,32
06-04-2020 10:00:00,2,1,1,35,18,17,9,4,5,11,15
06-04-2020 11:00:00,2,2,0,45,18,27,8,5,3,25,14
06-04-2020 12:00:00,2,1,1,61,28,33,14,11,3,16,21
06-04-2020 13:00:00,6,3,3,77,47,30,29,20,9,28,21
06-04-2020 14:00:00,4,4,0,76,28,48,17,12,5,32,22
06-04-2020 15:00:00,2,0,2,86,43,43,23,10,13,38,18
06-04-2020 16:00:00,9,8,1,100,45,55,41,24,17,57,35
06-04-2020 17:00:00,6,2,4,133,71,62,42,24,18,66,34
06-04-2020 18:00:00,11,4,7,116,59,57,34,18,16,54,25
06-04-2020 19:00:00,6,3,3,91,41,50,28,18,10,27,19
06-04-2020 20:00:00,5,3,2,69,30,39,15,5,10,15,23
06-04-2020 21:00:00,5,3,2,28,21,7,14,5,9,18,9
06-04-2020 22:00:00,2,2,0,23,9,14,5,1,4,10,6
06-04-2020 23:00:00,1,1,0,13,10,3,7,3,4,7,1
07-04-2020 00:00:00,0,0,0,4,3,1,2,0,2,4,3
07-04-2020 01:00:00,0,0,0,0,0,0,0,0,0,1,1
07-04-2020 02:00:00,0,0,0,0,0,0,1,0,1,1,0
07-04-2020 03:00:00,0,0,0,3,3,0,1,1,0,0,0
07-04-2020 04:00:00,0,0,0,5,1,4,4,3,1,1,4
07-04-2020 05:00:00,1,0,1,8,2,6,1,0,1,1,5
07-04-2020 06:00:00,1,1,0,35,11,24,13,13,0,10,25
07-04-2020 07:00:00,2,2,0,76,24,52,28,24,4,9,49
07-04-2020 08:00:00,4,3,1,89,28,61,36,30,6,17,55
07-04-2020 09:00:00,1,1,0,51,17,34,10,10,0,15,28
07-04-2020 10:00:00,1,0,1,32,17,15,9,6,3,17,14
07-04-2020 11:00:00,7,3,4,48,14,34,10,6,4,24,25
07-04-2020 12:00:00,5,4,1,80,33,47,27,18,9,41,28
07-04-2020 13:00:00,2,1,1,99,42,57,39,22,17,39,19
07-04-2020 14:00:00,10,7,3,107,54,53,33,16,17,35,37
07-04-2020 15:00:00,8,6,2,94,41,53,34,25,9,47,41
07-04-2020 16:00:00,13,8,5,139,54,85,37,23,14,81,44
07-04-2020 17:00:00,10,5,5,179,93,86,47,30,17,76,39
07-04-2020 18:00:00,7,2,5,165,85,80,46,31,15,62,35
07-04-2020 19:00:00,8,6,2,108,52,56,25,15,10,46,31
07-04-2020 20:00:00,5,1,4,79,45,34,29,19,10,21,26
07-04-2020 21:00:00,1,1,0,23,16,7,13,7,6,26,12
07-04-2020 22:00:00,3,1,2,23,16,7,4,1,3,8,7
07-04-2020 23:00:00,0,0,0,4,2,2,2,2,0,7,3
08-04-2020 00:00:00,2,1,1,4,2,2,3,0,3,2,2
08-04-2020 01:00:00,0,0,0,0,0,0,0,0,0,1,0
08-04-2020 02:00:00,0,0,0,1,1,0,1,0,1,2,0
08-04-2020 03:00:00,0,0,0,3,2,1,1,1,0,1,2
08-04-2020 04:00:00,0,0,0,7,3,4,2,2,0,1,1
08-04-2020 05:00:00,2,1,1,11,2,9,3,2,1,2,4
08-04-2020 06:00:00,2,1,1,40,13,27,13,13,0,6,23
08-04-2020 07:00:00,3,2,1,91,47,44,28,25,3,9,50
08-04-2020 08:00:00,5,2,3,113,42,71,38,34,4,16,57
08-04-2020 09:00:00,2,1,1,66,22,44,9,6,3,20,29
08-04-2020 10:00:00,1,1,0,38,15,23,7,5,2,10,16
08-04-2020 11:00:00,4,0,4,65,21,44,15,10,5,34,19
08-04-2020 12:00:00,3,2,1,70,32,38,12,5,7,36,24
08-04-2020 13:00:00,6,4,2,83,37,46,32,24,8,38,26
08-04-2020 14:00:00,8,6,2,91,41,50,22,16,6,41,32
08-04-2020 15:00:00,4,3,1,103,52,51,29,17,12,46,25
08-04-2020 16:00:00,4,2,2,93,45,48,31,16,15,51,36
08-04-2020 17:00:00,6,4,2,156,79,77,40,24,16,71,37
08-04-2020 18:00:00,12,8,4,136,66,70,33,19,14,68,33
08-04-2020 19:00:00,4,0,4,113,61,52,25,17,8,35,26
08-04-2020 20:00:00,3,1,2,70,35,35,18,12,6,12,16
08-04-2020 21:00:00,3,2,1,21,9,12,16,7,9,27,8
08-04-2020 22:00:00,1,1,0,22,14,8,5,5,0,5,4
08-04-2020 23:00:00,0,0,0,7,6,1,1,0,1,5,0
09-04-2020 00:00:00,2,0,2,4,2,2,0,0,0,4,1
09-04-2020 01:00:00,0,0,0,0,0,0,0,0,0,1,1
09-04-2020 02:00:00,0,0,0,3,2,1,0,0,0,0,0
09-04-2020 03:00:00,1,0,1,2,1,1,0,0,0,1,0
09-04-2020 04:00:00,0,0,0,7,3,4,2,2,0,3,5
09-04-2020 05:00:00,0,0,0,10,2,8,1,1,0,2,6
09-04-2020 06:00:00,2,1,1,37,12,25,11,11,0,7,24
09-04-2020 07:00:00,1,1,0,90,46,44,38,30,8,7,53
09-04-2020 08:00:00,0,0,0,108,36,72,31,28,3,18,61
09-04-2020 09:00:00,4,0,4,56,15,41,11,8,3,12,30
09-04-2020 10:00:00,1,0,1,45,14,31,16,10,6,20,25
09-04-2020 11:00:00,2,2,0,57,28,29,10,6,4,15,25
09-04-2020 12:00:00,1,1,0,74,32,42,19,14,5,29,24
09-04-2020 13:00:00,5,2,3,74,32,42,20,14,6,32,18
09-04-2020 14:00:00,1,1,0,79,39,40,29,16,13,32,24
09-04-2020 15:00:00,3,2,1,77,37,40,19,16,3,42,26
09-04-2020 16:00:00,2,2,0,120,58,62,26,17,9,65,23
09-04-2020 17:00:00,3,0,3,134,74,60,39,27,12,60,30
09-04-2020 18:00:00,11,10,1,115,55,60,32,25,7,74,34
09-04-2020 19:00:00,6,2,4,73,37,36,15,12,3,41,19
09-04-2020 20:00:00,2,2,0,65,30,35,22,10,12,26,19
09-04-2020 21:00:00,4,1,3,47,26,21,12,10,2,13,14
09-04-2020 22:00:00,1,0,1,23,17,6,9,7,2,12,3
09-04-2020 23:00:00,0,0,0,8,6,2,4,3,1,8,0
10-04-2020 00:00:00,0,0,0,2,2,0,0,0,0,1,1
10-04-2020 01:00:00,0,0,0,0,0,0,0,0,0,0,0
10-04-2020 02:00:00,0,0,0,1,1,0,1,0,1,2,0
10-04-2020 03:00:00,0,0,0,1,1,0,0,0,0,1,1
10-04-2020 04:00:00,0,0,0,5,2,3,0,0,0,3,0
10-04-2020 05:00:00,0,0,0,12,0,12,3,3,0,2,5
10-04-2020 06:00:00,1,1,0,31,14,17,9,9,0,8,11
10-04-2020 07:00:00,0,0,0,53,27,26,18,14,4,6,22
10-04-2020 08:00:00,2,2,0,52,24,28,20,18,2,12,38
10-04-2020 09:00:00,5,5,0,51,25,26,11,9,2,12,19
10-04-2020 10:00:00,5,3,2,64,29,35,12,11,1,28,18
10-04-2020 11:00:00,8,5,3,91,38,53,12,5,7,37,23
10-04-2020 12:00:00,6,4,2,81,42,39,17,13,4,30,20
10-04-2020 13:00:00,5,3,2,108,51,57,27,20,7,39,37
10-04-2020 14:00:00,6,3,3,117,57,60,35,21,14,43,32
10-04-2020 15:00:00,3,0,3,118,66,52,22,14,8,38,30
10-04-2020 16:00:00,5,2,3,122,64,58,24,10,14,34,32
10-04-2020 17:00:00,3,3,0,133,57,76,39,26,13,40,25
10-04-2020 18:00:00,7,5,2,119,58,61,27,16,11,44,39
10-04-2020 19:00:00,7,3,4,98,42,56,35,26,9,39,27
10-04-2020 20:00:00,6,4,2,78,33,45,19,11,8,26,20
10-04-2020 21:00:00,3,0,3,64,40,24,13,13,0,20,16
10-04-2020 22:00:00,3,2,1,28,21,7,4,3,1,17,11
10-04-2020 23:00:00,2,1,1,12,8,4,6,4,2,10,6
11-04-2020 00:00:00,1,0,1,6,3,3,0,0,0,3,1
11-04-2020 01:00:00,0,0,0,2,2,0,2,1,1,0,0
11-04-2020 02:00:00,0,0,0,0,0,0,0,0,0,0,0
11-04-2020 03:00:00,0,0,0,2,1,1,0,0,0,1,2
11-04-2020 04:00:00,0,0,0,3,0,3,1,1,0,0,2
11-04-2020 05:00:00,0,0,0,6,1,5,1,1,0,1,5
11-04-2020 06:00:00,2,0,2,21,4,17,13,12,1,4,11
11-04-2020 07:00:00,0,0,0,24,15,9,7,5,2,14,11
11-04-2020 08:00:00,0,0,0,32,11,21,20,18,2,11,25
11-04-2020 09:00:00,4,3,1,45,20,25,9,6,3,8,14
11-04-2020 10:00:00,2,2,0,63,24,39,13,10,3,21,10
11-04-2020 11:00:00,2,2,0,98,47,51,18,12,6,22,17
11-04-2020 12:00:00,4,2,2,86,36,50,31,22,9,32,29
11-04-2020 13:00:00,10,4,6,92,35,57,38,27,11,43,30
11-04-2020 14:00:00,7,6,1,122,52,70,37,23,14,41,23
11-04-2020 15:00:00,11,5,6,137,49,88,66,52,14,48,42
11-04-2020 16:00:00,9,5,4,184,84,100,39,25,14,41,48
11-04-2020 17:00:00,11,7,4,121,59,62,62,40,22,48,45
11-04-2020 18:00:00,3,2,1,129,47,82,47,27,20,47,27
11-04-2020 19:00:00,5,3,2,107,43,64,31,22,9,37,33
11-04-2020 20:00:00,2,1,1,75,40,35,22,15,7,39,35
11-04-2020 21:00:00,7,4,3,35,22,13,13,4,9,18,11
11-04-2020 22:00:00,5,3,2,25,14,11,13,8,5,15,6
11-04-2020 23:00:00,0,0,0,9,7,2,3,1,2,9,3
12-04-2020 00:00:00,1,1,0,4,3,1,2,2,0,2,1
12-04-2020 01:00:00,0,0,0,0,0,0,2,1,1,2,1
12-04-2020 02:00:00,0,0,0,2,1,1,3,2,1,2,1
12-04-2020 03:00:00,0,0,0,2,2,0,0,0,0,0,0
12-04-2020 04:00:00,0,0,0,0,0,0,0,0,0,0,1
12-04-2020 05:00:00,0,0,0,4,1,3,2,2,0,0,3
12-04-2020 06:00:00,2,0,2,9,2,7,5,5,0,3,10
12-04-2020 07:00:00,0,0,0,25,11,14,12,8,4,9,5
12-04-2020 08:00:00,0,0,0,19,7,12,10,8,2,12,8
12-04-2020 09:00:00,2,2,0,14,10,4,4,3,1,2,8
12-04-2020 10:00:00,0,0,0,15,3,12,4,4,0,6,5
12-04-2020 11:00:00,0,0,0,26,8,18,1,1,0,5,3
12-04-2020 12:00:00,6,4,2,26,13,13,8,7,1,13,7
12-04-2020 13:00:00,4,1,3,41,18,23,22,18,4,20,13
12-04-2020 14:00:00,0,0,0,53,22,31,25,19,6,11,18
12-04-2020 15:00:00,10,7,3,49,17,32,14,10,4,10,9
12-04-2020 16:00:00,1,1,0,58,29,29,20,14,6,18,12
12-04-2020 17:00:00,4,1,3,76,32,44,26,19,7,16,25
12-04-2020 18:00:00,5,3,2,55,23,32,17,11,6,25,7
12-04-2020 19:00:00,6,3,3,69,37,32,29,20,9,25,18
12-04-2020 20:00:00,1,0,1,61,34,27,16,8,8,16,6
12-04-2020 21:00:00,2,0,2,35,19,16,15,10,5,12,5
12-04-2020 22:00:00,0,0,0,21,12,9,9,8,1,5,1
12-04-2020 23:00:00,1,0,1,12,9,3,4,3,1,3,2
13-04-2020 00:00:00,0,0,0,1,0,1,0,0,0,4,1
13-04-2020 01:00:00,0,0,0,3,1,2,1,0,1,1,0
13-04-2020 02:00:00,0,0,0,1,0,1,0,0,0,1,0
13-04-2020 03:00:00,0,0,0,4,4,0,0,0,0,2,0
13-04-2020 04:00:00,0,0,0,5,5,0,2,2,0,0,2
13-04-2020 05:00:00,0,0,0,6,1,5,0,0,0,0,5
13-04-2020 06:00:00,0,0,0,9,2,7,7,7,0,2,12
13-04-2020 07:00:00,1,1,0,26,16,10,11,8,3,4,9
13-04-2020 08:00:00,0,0,0,24,7,17,8,8,0,5,8
13-04-2020 09:00:00,4,1,3,40,24,16,7,6,1,12,13
13-04-2020 10:00:00,1,1,0,41,17,24,11,7,4,17,14
13-04-2020 11:00:00,1,0,1,74,37,37,8,7,1,14,8
13-04-2020 12:00:00,3,2,1,62,27,35,13,10,3,17,16
13-04-2020 13:00:00,17,11,6,89,36,53,34,16,18,48,17
13-04-2020 14:00:00,8,3,5,77,35,42,23,16,7,33,38
13-04-2020 15:00:00,3,1,2,97,49,48,27,14,13,23,32
13-04-2020 16:00:00,7,3,4,77,36,41,24,15,9,28,35
13-04-2020 17:00:00,1,1,0,104,46,58,17,8,9,41,27
13-04-2020 18:00:00,7,1,6,103,48,55,41,28,13,27,25
13-04-2020 19:00:00,3,2,1,80,35,45,34,19,15,24,17
13-04-2020 20:00:00,5,2,3,55,33,22,23,13,10,17,17
13-04-2020 21:00:00,3,2,1,34,21,13,16,10,6,11,4
13-04-2020 22:00:00,1,0,1,14,8,6,5,3,2,9,10
13-04-2020 23:00:00,0,0,0,5,3,2,4,1,3,2,2
14-04-2020 00:00:00,1,1,0,8,6,2,0,0,0,2,2
14-04-2020 01:00:00,0,0,0,1,1,0,0,0,0,0,1
14-04-2020 02:00:00,0,0,0,2,1,1,1,0,1,0,0
14-04-2020 03:00:00,0,0,0,3,3,0,1,1,0,0,0
14-04-2020 04:00:00,0,0,0,5,2,3,2,2,0,1,2
14-04-2020 05:00:00,1,0,1,15,3,12,6,5,1,0,5
14-04-2020 06:00:00,2,1,1,39,11,28,17,17,0,5,22
14-04-2020 07:00:00,2,1,1,79,30,49,25,15,10,11,50
14-04-2020 08:00:00,3,0,3,107,44,63,36,33,3,19,65
14-04-2020 09:00:00,5,4,1,68,27,41,9,8,1,4,24
14-04-2020 10:00:00,4,2,2,48,16,32,11,9,2,22,16
14-04-2020 11:00:00,3,1,2,70,25,45,12,7,5,25,21
14-04-2020 12:00:00,2,1,1,112,49,63,23,16,7,27,29
14-04-2020 13:00:00,7,3,4,106,48,58,30,20,10,24,20
14-04-2020 14:00:00,14,10,4,108,52,56,24,16,8,32,32
14-04-2020 15:00:00,8,4,4,95,45,50,27,12,15,61,27
14-04-2020 16:00:00,11,3,8,144,70,74,38,21,17,73,49
14-04-2020 17:00:00,5,4,1,169,76,93,29,17,12,77,30
14-04-2020 18:00:00,15,10,5,139,76,63,31,24,7,56,33
14-04-2020 19:00:00,4,1,3,117,63,54,34,26,8,45,21
14-04-2020 20:00:00,5,3,2,78,40,38,20,12,8,27,21
14-04-2020 21:00:00,1,0,1,28,15,13,17,10,7,21,8
14-04-2020 22:00:00,2,2,0,14,9,5,12,5,7,5,4
14-04-2020 23:00:00,0,0,0,10,4,6,2,1,1,9,3
15-04-2020 00:00:00,0,0,0,3,3,0,0,0,0,2,2
15-04-2020 01:00:00,0,0,0,3,1,2,0,0,0,0,1
15-04-2020 02:00:00,2,0,2,1,1,0,2,1,1,0,0
15-04-2020 03:00:00,0,0,0,3,3,0,1,1,0,0,0
15-04-2020 04:00:00,0,0,0,3,1,2,2,2,0,1,1
15-04-2020 05:00:00,1,0,1,10,3,7,3,2,1,0,4
15-04-2020 06:00:00,2,1,1,37,14,23,9,8,1,5,29
15-04-2020 07:00:00,1,0,1,77,31,46,28,22,6,9,45
15-04-2020 08:00:00,5,2,3,122,45,77,38,32,6,20,68
15-04-2020 09:00:00,5,2,3,57,19,38,15,14,1,17,17
15-04-2020 10:00:00,1,1,0,51,20,31,18,13,5,16,21
15-04-2020 11:00:00,6,3,3,71,30,41,13,11,2,23,15
15-04-2020 12:00:00,9,7,2,72,44,28,26,20,6,29,23
15-04-2020 13:00:00,7,6,1,102,56,46,35,25,10,49,27
15-04-2020 14:00:00,10,6,4,95,41,54,27,18,9,52,47
15-04-2020 15:00:00,10,6,4,112,40,72,32,25,7,49,38
15-04-2020 16:00:00,4,1,3,148,67,81,31,18,13,67,15
15-04-2020 17:00:00,11,6,5,167,95,72,34,16,18,84,33
15-04-2020 18:00:00,8,4,4,168,80,88,38,21,17,68,48
15-04-2020 19:00:00,6,5,1,124,60,64,18,12,6,37,28
15-04-2020 20:00:00,4,2,2,81,49,32,29,14,15,26,26
15-04-2020 21:00:00,1,1,0,38,28,10,10,7,3,25,9
15-04-2020 22:00:00,2,2,0,23,14,9,7,3,4,16,5
15-04-2020 23:00:00,4,1,3,9,3,6,6,2,4,2,4
16-04-2020 00:00:00,1,0,1,5,2,3,1,1,0,2,1
16-04-2020 01:00:00,0,0,0,2,1,1,1,0,1,0,1
16-04-2020 02:00:00,0,0,0,1,1,0,0,0,0,0,0
16-04-2020 03:00:00,0,0,0,3,3,0,0,0,0,0,0
16-04-2020 04:00:00,1,0,1,5,3,2,2,2,0,0,2
16-04-2020 05:00:00,1,0,1,16,4,12,7,6,1,1,5
16-04-2020 06:00:00,2,1,1,23,10,13,18,18,0,6,29
16-04-2020 07:00:00,2,1,1,90,35,55,32,25,7,9,35
16-04-2020 08:00:00,3,2,1,92,29,63,40,34,6,16,53
16-04-2020 09:00:00,3,3,0,51,19,32,9,8,1,10,24
16-04-2020 10:00:00,4,1,3,49,15,34,15,11,4,17,27
16-04-2020 11:00:00,3,2,1,50,15,35,10,8,2,33,27
16-04-2020 12:00:00,4,4,0,83,40,43,19,14,5,28,19
16-04-2020 13:00:00,9,7,2,92,50,42,39,26,13,45,20
16-04-2020 14:00:00,6,4,2,74,36,38,33,16,17,46,37
16-04-2020 15:00:00,6,6,0,111,53,58,26,21,5,69,28
16-04-2020 16:00:00,3,1,2,140,70,70,36,22,14,71,24
16-04-2020 17:00:00,11,6,5,177,76,101,41,25,16,80,41
16-04-2020 18:00:00,9,4,5,140,64,76,40,30,10,48,30
16-04-2020 19:00:00,12,5,7,114,53,61,42,21,21,31,27
16-04-2020 20:00:00,5,2,3,87,38,49,21,15,6,23,13
16-04-2020 21:00:00,1,1,0,48,30,18,14,11,3,25,14
16-04-2020 22:00:00,1,0,1,19,14,5,8,2,6,12,2
16-04-2020 23:00:00,1,1,0,9,6,3,2,1,1,5,1
17-04-2020 00:00:00,0,0,0,4,2,2,0,0,0,7,1
17-04-2020 01:00:00,1,0,1,2,1,1,0,0,0,0,2
17-04-2020 02:00:00,1,0,1,2,2,0,0,0,0,0,0
17-04-2020 03:00:00,0,0,0,2,1,1,2,2,0,0,1
17-04-2020 04:00:00,0,0,0,5,2,3,0,0,0,1,1
17-04-2020 05:00:00,0,0,0,16,5,11,5,4,1,3,4
17-04-2020 06:00:00,1,1,0,37,13,24,17,17,0,8,27
17-04-2020 07:00:00,1,0,1,86,30,56,25,20,5,6,45
17-04-2020 08:00:00,5,2,3,106,39,67,33,32,1,22,58
17-04-2020 09:00:00,6,4,2,56,23,33,17,16,1,9,22
17-04-2020 10:00:00,6,3,3,63,22,41,16,13,3,21,21
17-04-2020 11:00:00,4,2,2,89,40,49,21,10,11,20,28
17-04-2020 12:00:00,4,2,2,85,44,41,23,16,7,34,35
17-04-2020 13:00:00,7,2,5,106,50,56,36,25,11,34,46
17-04-2020 14:00:00,4,3,1,107,47,60,33,17,16,41,33
17-04-2020 15:00:00,12,9,3,91,46,45,17,12,5,58,28
17-04-2020 16:00:00,14,6,8,106,46,60,24,14,10,50,26
17-04-2020 17:00:00,9,4,5,128,67,61,35,27,8,66,42
17-04-2020 18:00:00,7,4,3,108,51,57,32,25,7,64,39
17-04-2020 19:00:00,12,9,3,97,53,44,18,12,6,34,16
17-04-2020 20:00:00,5,4,1,88,43,45,25,16,9,24,19
17-04-2020 21:00:00,4,2,2,45,23,22,16,10,6,25,20
17-04-2020 22:00:00,3,2,1,35,19,16,11,6,5,13,13
17-04-2020 23:00:00,0,0,0,15,12,3,5,3,2,8,5
18-04-2020 00:00:00,0,0,0,6,1,5,1,1,0,2,1
18-04-2020 01:00:00,1,0,1,4,4,0,1,1,0,0,0
18-04-2020 02:00:00,1,0,1,2,0,2,1,0,1,1,1
18-04-2020 03:00:00,0,0,0,2,2,0,0,0,0,1,1
18-04-2020 04:00:00,0,0,0,3,1,2,0,0,0,0,1
18-04-2020 05:00:00,2,0,2,3,1,2,2,1,1,1,2
18-04-2020 06:00:00,3,0,3,17,6,11,7,6,1,2,6
18-04-2020 07:00:00,0,0,0,34,19,15,8,5,3,3,13
18-04-2020 08:00:00,0,0,0,28,12,16,13,12,1,4,16
18-04-2020 09:00:00,2,1,1,30,11,19,6,4,2,10,12
18-04-2020 10:00:00,2,1,1,51,29,22,15,14,1,10,8
18-04-2020 11:00:00,2,2,0,65,26,39,13,10,3,22,12
18-04-2020 12:00:00,4,3,1,75,40,35,23,14,9,25,22
18-04-2020 13:00:00,4,2,2,65,30,35,15,10,5,30,24
18-04-2020 14:00:00,7,5,2,81,38,43,36,24,12,30,33
18-04-2020 15:00:00,4,3,1,94,52,42,34,21,13,38,23
18-04-2020 16:00:00,4,4,0,105,41,64,27,18,9,29,31
18-04-2020 17:00:00,4,4,0,106,46,60,32,23,9,37,22
18-04-2020 18:00:00,9,4,5,114,56,58,33,23,10,32,25
18-04-2020 19:00:00,2,1,1,61,35,26,22,19,3,37,19
18-04-2020 20:00:00,5,3,2,54,30,24,19,12,7,27,17
18-04-2020 21:00:00,5,3,2,42,22,20,14,7,7,10,8
18-04-2020 22:00:00,3,3,0,27,17,10,8,6,2,22,3
18-04-2020 23:00:00,1,0,1,10,6,4,5,3,2,7,4
19-04-2020 00:00:00,0,0,0,7,6,1,0,0,0,2,2
19-04-2020 01:00:00,0,0,0,2,2,0,0,0,0,0,0
19-04-2020 02:00:00,0,0,0,3,1,2,0,0,0,0,1
19-04-2020 03:00:00,1,0,1,3,3,0,0,0,0,0,0
19-04-2020 04:00:00,0,0,0,2,0,2,0,0,0,0,1
19-04-2020 05:00:00,0,0,0,5,1,4,3,3,0,0,1
19-04-2020 06:00:00,2,0,2,15,6,9,4,4,0,2,6
19-04-2020 07:00:00,0,0,0,21,6,15,13,7,6,7,9
19-04-2020 08:00:00,0,0,0,31,15,16,11,8,3,3,5
19-04-2020 09:00:00,1,1,0,26,16,10,9,7,2,11,6
19-04-2020 10:00:00,4,2,2,45,21,24,12,8,4,18,16
19-04-2020 11:00:00,8,3,5,73,27,46,16,10,6,21,29
19-04-2020 12:00:00,4,2,2,105,46,59,16,13,3,24,35
19-04-2020 13:00:00,9,2,7,105,51,54,43,28,15,32,31
19-04-2020 14:00:00,8,3,5,117,59,58,27,18,9,60,27
19-04-2020 15:00:00,7,1,6,128,53,75,40,29,11,27,40
19-04-2020 16:00:00,4,3,1,133,70,63,42,27,15,37,48
19-04-2020 17:00:00,4,2,2,109,43,66,46,20,26,51,44
19-04-2020 18:00:00,3,2,1,138,65,73,37,26,11,48,25
19-04-2020 19:00:00,2,0,2,88,38,50,33,27,6,23,28
19-04-2020 20:00:00,8,3,5,74,32,42,30,22,8,17,20
19-04-2020 21:00:00,3,1,2,42,26,16,16,7,9,20,16
19-04-2020 22:00:00,4,3,1,17,9,8,12,9,3,10,9
19-04-2020 23:00:00,3,2,1,7,5,2,3,2,1,10,1
20-04-2020 00:00:00,0,0,0,2,0,2,0,0,0,1,2
20-04-2020 01:00:00,0,0,0,2,2,0,1,0,1,0,1
20-04-2020 02:00:00,0,0,0,1,1,0,0,0,0,1,3
20-04-2020 03:00:00,0,0,0,1,1,0,1,1,0,1,1
20-04-2020 04:00:00,0,0,0,7,1,6,1,1,0,1,1
20-04-2020 05:00:00,1,0,1,11,4,7,4,4,0,1,10
20-04-2020 06:00:00,3,3,0,30,8,22,15,15,0,8,20
20-04-2020 07:00:00,3,1,2,84,39,45,30,23,7,10,45
20-04-2020 08:00:00,3,2,1,119,45,74,44,41,3,16,49
20-04-2020 09:00:00,3,2,1,61,17,44,13,10,3,11,23
20-04-2020 10:00:00,7,7,0,62,21,41,11,7,4,17,17
20-04-2020 11:00:00,4,3,1,58,22,36,12,8,4,18,15
20-04-2020 12:00:00,4,3,1,66,32,34,25,14,11,25,23
20-04-2020 13:00:00,4,2,2,89,35,54,34,31,3,41,28
20-04-2020 14:00:00,6,3,3,86,38,48,33,17,16,35,25
20-04-2020 15:00:00,6,3,3,101,49,52,20,13,7,53,32
20-04-2020 16:00:00,10,6,4,119,65,54,37,22,15,57,39
20-04-2020 17:00:00,8,3,5,137,59,78,39,29,10,64,30
20-04-2020 18:00:00,12,11,1,141,52,89,44,29,15,72,38
20-04-2020 19:00:00,3,1,2,119,57,62,37,28,9,33,27
20-04-2020 20:00:00,4,2,2,60,33,27,28,21,7,23,18
20-04-2020 21:00:00,5,2,3,30,18,12,15,10,5,24,5
20-04-2020 22:00:00,2,1,1,30,23,7,6,4,2,4,7
20-04-2020 23:00:00,1,1,0,10,5,5,1,1,0,6,3
21-04-2020 00:00:00,0,0,0,7,4,3,0,0,0,0,1
21-04-2020 01:00:00,0,0,0,2,2,0,0,0,0,0,1
21-04-2020 02:00:00,1,0,1,0,0,0,0,0,0,0,0
21-04-2020 03:00:00,0,0,0,1,1,0,1,1,0,1,1
21-04-2020 04:00:00,0,0,0,8,3,5,1,1,0,3,2
21-04-2020 05:00:00,1,0,1,14,4,10,4,3,1,3,8
21-04-2020 06:00:00,0,0,0,33,9,24,19,18,1,10,30
21-04-2020 07:00:00,2,1,1,84,28,56,39,31,8,9,48
21-04-2020 08:00:00,2,2,0,103,34,69,36,31,5,23,48
21-04-2020 09:00:00,6,3,3,64,26,38,17,14,3,16,39
21-04-2020 10:00:00,4,2,2,50,12,38,20,15,5,22,21
21-04-2020 11:00:00,5,3,2,61,30,31,14,10,4,22,23
21-04-2020 12:00:00,5,2,3,95,48,47,29,22,7,23,25
21-04-2020 13:00:00,7,4,3,82,45,37,30,22,8,32,28
21-04-2020 14:00:00,8,4,4,81,41,40,24,16,8,38,33
21-04-2020 15:00:00,6,4,2,86,42,44,31,23,8,45,29
21-04-2020 16:00:00,18,12,6,155,65,90,40,18,22,76,33
21-04-2020 17:00:00,3,2,1,198,98,100,50,25,25,81,41
21-04-2020 18:00:00,3,3,0,166,79,87,49,27,22,68,36
21-04-2020 19:00:00,6,4,2,117,57,60,34,18,16,39,34
21-04-2020 20:00:00,2,0,2,68,38,30,30,24,6,28,24
21-04-2020 21:00:00,2,0,2,31,21,10,10,9,1,21,8
21-04-2020 22:00:00,3,3,0,23,16,7,19,12,7,13,16
21-04-2020 23:00:00,0,0,0,6,4,2,3,0,3,9,3
22-04-2020 00:00:00,2,0,2,7,2,5,0,0,0,6,4
22-04-2020 01:00:00,1,0,1,1,0,1,1,0,1,1,0
22-04-2020 02:00:00,1,1,0,2,1,1,0,0,0,1,0
22-04-2020 03:00:00,0,0,0,2,2,0,1,1,0,0,0
22-04-2020 04:00:00,0,0,0,5,2,3,0,0,0,1,1
22-04-2020 05:00:00,2,0,2,18,4,14,4,3,1,0,8
22-04-2020 06:00:00,0,0,0,34,14,20,13,13,0,12,27
22-04-2020 07:00:00,2,1,1,82,33,49,30,22,8,13,69
22-04-2020 08:00:00,5,3,2,119,40,79,40,33,7,22,68
22-04-2020 09:00:00,5,4,1,59,25,34,21,19,2,16,27
22-04-2020 10:00:00,1,1,0,39,17,22,13,11,2,16,16
22-04-2020 11:00:00,7,2,5,56,26,30,16,15,1,17,20
22-04-2020 12:00:00,3,1,2,80,35,45,15,11,4,32,23
22-04-2020 13:00:00,2,1,1,90,36,54,28,19,9,44,25
22-04-2020 14:00:00,10,6,4,66,32,34,25,20,5,51,36
22-04-2020 15:00:00,4,1,3,103,54,49,29,23,6,52,45
22-04-2020 16:00:00,7,6,1,129,66,63,32,17,15,72,36
22-04-2020 17:00:00,12,9,3,175,88,87,45,32,13,83,33
22-04-2020 18:00:00,2,1,1,155,73,82,54,35,19,81,29
22-04-2020 19:00:00,9,3,6,165,87,78,35,18,17,45,31
22-04-2020 20:00:00,18,13,5,95,45,50,18,11,7,23,18
22-04-2020 21:00:00,7,5,2,42,27,15,15,10,5,16,15
22-04-2020 22:00:00,5,1,4,20,15,5,8,5,3,16,10
22-04-2020 23:00:00,2,0,2,9,4,5,4,1,3,11,5
23-04-2020 00:00:00,0,0,0,6,5,1,3,2,1,3,4
23-04-2020 01:00:00,0,0,0,3,3,0,2,1,1,2,2
23-04-2020 02:00:00,0,0,0,0,0,0,1,0,1,0,0
23-04-2020 03:00:00,0,0,0,2,2,0,2,1,1,0,0
23-04-2020 04:00:00,0,0,0,9,3,6,0,0,0,0,2
23-04-2020 05:00:00,1,0,1,15,3,12,4,3,1,1,3
23-04-2020 06:00:00,0,0,0,39,10,29,19,18,1,8,22
23-04-2020 07:00:00,0,0,0,88,36,52,32,26,6,10,63
23-04-2020 08:00:00,1,1,0,116,49,67,30,27,3,20,61
23-04-2020 09:00:00,6,6,0,64,22,42,16,16,0,18,35
23-04-2020 10:00:00,4,3,1,63,20,43,12,10,2,19,25
23-04-2020 11:00:00,10,5,5,65,22,43,18,14,4,16,17
23-04-2020 12:00:00,4,2,2,82,43,39,35,18,17,34,43
23-04-2020 13:00:00,8,7,1,120,46,74,42,28,14,40,30
23-04-2020 14:00:00,10,7,3,102,52,50,47,31,16,67,53
23-04-2020 15:00:00,4,4,0,107,54,53,36,21,15,54,44
23-04-2020 16:00:00,11,4,7,131,57,74,48,34,14,84,39
23-04-2020 17:00:00,5,3,2,176,87,89,50,26,24,66,42
23-04-2020 18:00:00,9,5,4,181,94,87,54,34,20,58,46
23-04-2020 19:00:00,6,2,4,122,57,65,31,24,7,47,37
23-04-2020 20:00:00,3,1,2,91,45,46,26,20,6,38,30
23-04-2020 21:00:00,3,2,1,40,22,18,31,16,15,20,14
23-04-2020 22:00:00,7,3,4,33,23,10,6,2,4,13,15
23-04-2020 23:00:00,2,0,2,12,8,4,4,2,2,9,5
24-04-2020 00:00:00,1,1,0,5,1,4,2,1,1,9,4
24-04-2020 01:00:00,0,0,0,4,3,1,0,0,0,0,1
24-04-2020 02:00:00,0,0,0,1,1,0,0,0,0,0,0
24-04-2020 03:00:00,0,0,0,0,0,0,0,0,0,0,0
24-04-2020 04:00:00,0,0,0,9,4,5,1,1,0,1,3
24-04-2020 05:00:00,1,0,1,16,4,12,4,4,0,2,4
24-04-2020 06:00:00,0,0,0,35,11,24,13,13,0,8,23
24-04-2020 07:00:00,1,1,0,96,30,66,32,23,9,17,38
24-04-2020 08:00:00,3,3,0,114,45,69,47,42,5,17,67
24-04-2020 09:00:00,10,8,2,76,33,43,22,17,5,13,30
24-04-2020 10:00:00,6,5,1,57,21,36,11,9,2,19,11
24-04-2020 11:00:00,3,2,1,69,28,41,17,8,9,24,30
24-04-2020 12:00:00,3,2,1,73,39,34,41,26,15,39,40
24-04-2020 13:00:00,10,8,2,123,48,75,25,17,8,53,41
24-04-2020 14:00:00,11,6,5,104,44,60,35,22,13,56,29
24-04-2020 15:00:00,11,9,2,98,42,56,29,19,10,51,24
24-04-2020 16:00:00,12,4,8,154,66,88,45,30,15,80,55
24-04-2020 17:00:00,7,3,4,173,90,83,46,36,10,68,64
24-04-2020 18:00:00,13,10,3,184,96,88,49,30,19,86,42
24-04-2020 19:00:00,8,7,1,138,76,62,36,27,9,39,52
24-04-2020 20:00:00,14,8,6,89,50,39,35,28,7,34,30
24-04-2020 21:00:00,3,2,1,60,36,24,25,16,9,28,23
24-04-2020 22:00:00,1,1,0,39,25,14,9,7,2,24,6
24-04-2020 23:00:00,1,1,0,10,7,3,4,2,2,15,8
25-04-2020 00:00:00,0,0,0,10,5,5,2,1,1,2,5
25-04-2020 01:00:00,1,0,1,4,2,2,1,1,0,2,2
25-04-2020 02:00:00,1,0,1,4,1,3,2,2,0,1,2
25-04-2020 03:00:00,0,0,0,2,1,1,1,1,0,2,0
25-04-2020 04:00:00,2,2,0,3,0,3,0,0,0,2,2
25-04-2020 05:00:00,0,0,0,12,5,7,6,5,1,3,3
25-04-2020 06:00:00,3,0,3,18,4,14,7,6,1,6,8
25-04-2020 07:00:00,0,0,0,38,15,23,14,8,6,4,10
25-04-2020 08:00:00,2,1,1,29,12,17,13,12,1,10,19
25-04-2020 09:00:00,6,3,3,38,17,21,13,7,6,23,19
25-04-2020 10:00:00,3,1,2,54,18,36,18,15,3,21,30
25-04-2020 11:00:00,5,4,1,80,31,49,29,18,11,36,31
25-04-2020 12:00:00,5,3,2,129,51,78,43,33,10,47,35
25-04-2020 13:00:00,7,3,4,180,85,95,51,37,14,67,48
25-04-2020 14:00:00,25,18,7,162,74,88,39,29,10,80,51
25-04-2020 15:00:00,14,11,3,166,75,91,51,27,24,56,45
25-04-2020 16:00:00,18,11,7,160,76,84,32,18,14,61,61
25-04-2020 17:00:00,4,3,1,152,77,75,42,29,13,38,49
25-04-2020 18:00:00,5,4,1,133,62,71,41,30,11,59,44
25-04-2020 19:00:00,3,1,2,110,65,45,41,26,15,43,40
25-04-2020 20:00:00,6,3,3,76,35,41,26,15,11,35,34
25-04-2020 21:00:00,9,2,7,59,31,28,18,10,8,28,20
25-04-2020 22:00:00,2,1,1,29,15,14,16,11,5,20,20
25-04-2020 23:00:00,6,3,3,22,10,12,6,3,3,7,1
26-04-2020 00:00:00,0,0,0,8,4,4,4,4,0,9,2
26-04-2020 01:00:00,0,0,0,4,2,2,1,1,0,1,2
26-04-2020 02:00:00,0,0,0,1,0,1,1,0,1,1,0
26-04-2020 03:00:00,0,0,0,3,2,1,0,0,0,0,1
26-04-2020 04:00:00,0,0,0,2,0,2,0,0,0,0,1
26-04-2020 05:00:00,0,0,0,4,1,3,2,1,1,1,3
26-04-2020 06:00:00,1,0,1,17,5,12,5,5,0,1,8
26-04-2020 07:00:00,3,3,0,28,12,16,10,8,2,9,8
26-04-2020 08:00:00,0,0,0,42,20,22,15,11,4,9,11
26-04-2020 09:00:00,3,1,2,39,23,16,14,9,5,14,18
26-04-2020 10:00:00,1,0,1,55,20,35,8,6,2,17,16
26-04-2020 11:00:00,3,3,0,61,28,33,23,18,5,19,28
26-04-2020 12:00:00,8,7,1,98,30,68,19,10,9,27,14
26-04-2020 13:00:00,9,6,3,81,41,40,35,23,12,37,42
26-04-2020 14:00:00,6,2,4,114,51,63,19,10,9,49,23
26-04-2020 15:00:00,5,3,2,91,35,56,36,25,11,37,41
26-04-2020 16:00:00,5,4,1,108,51,57,36,23,13,39,59
26-04-2020 17:00:00,13,9,4,86,44,42,28,19,9,36,30
26-04-2020 18:00:00,7,2,5,95,57,38,33,21,12,30,39
26-04-2020 19:00:00,6,4,2,73,40,33,27,13,14,32,33
26-04-2020 20:00:00,5,4,1,73,36,37,23,15,8,21,12
26-04-2020 21:00:00,1,0,1,38,22,16,10,4,6,15,17
26-04-2020 22:00:00,0,0,0,25,12,13,12,7,5,12,6
26-04-2020 23:00:00,0,0,0,3,1,2,2,1,1,8,2
27-04-2020 00:00:00,0,0,0,1,0,1,1,1,0,1,1
27-04-2020 01:00:00,2,0,2,1,1,0,0,0,0,0,1
27-04-2020 02:00:00,0,0,0,3,2,1,1,0,1,0,0
27-04-2020 03:00:00,0,0,0,0,0,0,1,1,0,2,0
27-04-2020 04:00:00,0,0,0,5,2,3,2,2,0,1,1
27-04-2020 05:00:00,1,0,1,13,6,7,5,5,0,2,8
27-04-2020 06:00:00,1,1,0,37,10,27,17,17,0,8,27
27-04-2020 07:00:00,2,0,2,92,37,55,32,25,7,16,53
27-04-2020 08:00:00,4,2,2,120,49,71,52,48,4,21,58
27-04-2020 09:00:00,3,2,1,64,18,46,11,10,1,21,23
27-04-2020 10:00:00,1,1,0,65,25,40,17,10,7,23,20
27-04-2020 11:00:00,7,5,2,65,36,29,17,10,7,11,15
27-04-2020 12:00:00,6,3,3,75,34,41,30,18,12,27,29
27-04-2020 13:00:00,4,1,3,101,45,56,36,18,18,40,34
27-04-2020 14:00:00,6,2,4,99,45,54,41,25,16,51,31
27-04-2020 15:00:00,13,8,5,96,50,46,39,23,16,52,44
27-04-2020 16:00:00,14,10,4,123,60,63,36,21,15,71,56
27-04-2020 17:00:00,10,5,5,158,86,72,41,27,14,89,48
27-04-2020 18:00:00,11,6,5,151,69,82,50,37,13,86,38
27-04-2020 19:00:00,7,1,6,124,70,54,34,21,13,45,29
27-04-2020 20:00:00,8,6,2,100,50,50,20,12,8,28,23
27-04-2020 21:00:00,5,2,3,31,14,17,19,11,8,23,16
27-04-2020 22:00:00,1,1,0,26,18,8,12,10,2,12,11
27-04-2020 23:00:00,0,0,0,7,5,2,5,1,4,5,3
28-04-2020 00:00:00,2,0,2,7,4,3,1,1,0,3,4
28-04-2020 01:00:00,0,0,0,1,0,1,0,0,0,2,0
28-04-2020 02:00:00,0,0,0,1,1,0,0,0,0,0,0
28-04-2020 03:00:00,0,0,0,2,1,1,1,1,0,0,0
28-04-2020 04:00:00,0,0,0,7,2,5,1,1,0,1,1
28-04-2020 05:00:00,0,0,0,14,7,7,5,5,0,2,8
28-04-2020 06:00:00,0,0,0,41,13,28,18,17,1,10,27
28-04-2020 07:00:00,2,2,0,100,45,55,44,35,9,11,52
28-04-2020 08:00:00,4,3,1,117,46,71,40,37,3,21,77
28-04-2020 09:00:00,4,2,2,78,26,52,18,14,4,15,46
28-04-2020 10:00:00,7,3,4,54,15,39,10,9,1,17,26
28-04-2020 11:00:00,4,2,2,70,31,39,16,12,4,19,27
28-04-2020 12:00:00,7,4,3,70,30,40,32,23,9,28,27
28-04-2020 13:00:00,5,3,2,93,38,55,26,16,10,47,38
28-04-2020 14:00:00,8,4,4,78,45,33,30,21,9,51,33
28-04-2020 15:00:00,7,4,3,89,48,41,32,23,9,53,46
28-04-2020 16:00:00,10,6,4,128,69,59,44,24,20,84,32
28-04-2020 17:00:00,12,7,5,172,84,88,46,31,15,76,44
28-04-2020 18:00:00,5,3,2,160,74,86,46,29,17,69,55
28-04-2020 19:00:00,8,6,2,112,52,60,30,23,7,57,42
28-04-2020 20:00:00,3,2,1,79,47,32,32,21,11,40,27
28-04-2020 21:00:00,1,1,0,29,15,14,18,9,9,22,14
28-04-2020 22:00:00,1,1,0,21,14,7,9,5,4,16,8
28-04-2020 23:00:00,0,0,0,5,2,3,1,1,0,15,4
29-04-2020 00:00:00,0,0,0,5,3,2,0,0,0,2,4
29-04-2020 01:00:00,0,0,0,4,2,2,0,0,0,1,1
29-04-2020 02:00:00,0,0,0,0,0,0,1,0,1,0,0
29-04-2020 03:00:00,0,0,0,2,2,0,1,1,0,1,0
29-04-2020 04:00:00,0,0,0,7,4,3,1,1,0,1,2
29-04-2020 05:00:00,2,1,1,11,4,7,5,4,1,2,6
29-04-2020 06:00:00,0,0,0,36,10,26,19,19,0,10,27
29-04-2020 07:00:00,1,0,1,83,32,51,27,19,8,12,50
29-04-2020 08:00:00,1,1,0,116,46,70,47,44,3,20,64
29-04-2020 09:00:00,5,3,2,54,19,35,23,18,5,10,35
29-04-2020 10:00:00,0,0,0,27,9,18,10,7,3,11,13
29-04-2020 11:00:00,5,3,2,31,13,18,12,9,3,11,12
29-04-2020 12:00:00,0,0,0,43,25,18,14,10,4,15,17
29-04-2020 13:00:00,3,2,1,64,20,44,16,12,4,26,26
29-04-2020 14:00:00,3,2,1,44,25,19,19,13,6,31,28
29-04-2020 15:00:00,4,3,1,84,40,44,35,28,7,43,21
29-04-2020 16:00:00,8,7,1,114,61,53,38,23,15,57,40
29-04-2020 17:00:00,9,4,5,138,62,76,31,21,10,81,36
29-04-2020 18:00:00,9,6,3,152,73,79,40,25,15,82,40
29-04-2020 19:00:00,7,4,3,104,53,51,31,22,9,50,23
29-04-2020 20:00:00,4,1,3,53,29,24,21,13,8,24,21
29-04-2020 21:00:00,5,3,2,22,16,6,7,5,2,25,10
29-04-2020 22:00:00,1,0,1,19,15,4,5,3,2,10,5
29-04-2020 23:00:00,0,0,0,6,3,3,2,1,1,3,1
30-04-2020 00:00:00,0,0,0,6,1,5,2,1,1,3,2
30-04-2020 01:00:00,0,0,0,1,0,1,0,0,0,0,0
30-04-2020 02:00:00,0,0,0,3,3,0,0,0,0,0,0
30-04-2020 03:00:00,0,0,0,1,1,0,0,0,0,0,0
30-04-2020 04:00:00,0,0,0,8,2,6,1,1,0,1,2
30-04-2020 05:00:00,1,1,0,14,5,9,4,3,1,3,4
30-04-2020 06:00:00,0,0,0,33,10,23,15,15,0,7,21
30-04-2020 07:00:00,3,1,2,71,21,50,28,22,6,4,38
30-04-2020 08:00:00,1,0,1,77,26,51,28,27,1,7,48
30-04-2020 09:00:00,2,1,1,61,23,38,13,9,4,16,21
30-04-2020 10:00:00,0,0,0,43,16,27,9,8,1,12,23
30-04-2020 11:00:00,1,0,1,51,18,33,13,11,2,11,13
30-04-2020 12:00:00,3,3,0,64,30,34,28,17,11,21,15
30-04-2020 13:00:00,5,4,1,54,32,22,17,13,4,25,26
30-04-2020 14:00:00,7,5,2,57,21,36,17,12,5,39,19
30-04-2020 15:00:00,2,2,0,60,32,28,22,10,12,43,27
30-04-2020 16:00:00,9,5,4,85,39,46,34,21,13,46,19
30-04-2020 17:00:00,9,3,6,110,58,52,42,23,19,67,26
30-04-2020 18:00:00,6,1,5,135,54,81,40,29,11,53,33
30-04-2020 19:00:00,9,5,4,93,51,42,27,18,9,42,18
30-04-2020 20:00:00,6,3,3,82,46,36,27,17,10,29,16
30-04-2020 21:00:00,1,1,0,42,24,18,15,8,7,21,20
30-04-2020 22:00:00,1,0,1,20,16,4,8,7,1,15,8
30-04-2020 23:00:00,1,1,0,11,5,6,4,2,2,5,3
01-05-2020 00:00:00,0,0,0,5,2,3,1,1,0,5,3
01-05-2020 01:00:00,2,0,2,2,1,1,0,0,0,2,2
01-05-2020 02:00:00,0,0,0,2,2,0,0,0,0,2,0
01-05-2020 03:00:00,0,0,0,1,1,0,3,1,2,1,0
01-05-2020 04:00:00,0,0,0,9,4,5,0,0,0,2,2
01-05-2020 05:00:00,1,1,0,11,5,6,6,6,0,4,3
01-05-2020 06:00:00,1,0,1,40,14,26,10,10,0,8,26
01-05-2020 07:00:00,1,0,1,84,32,52,34,27,7,15,41
01-05-2020 08:00:00,3,2,1,109,41,68,43,41,2,14,60
01-05-2020 09:00:00,2,1,1,71,22,49,22,16,6,15,28
01-05-2020 10:00:00,2,1,1,71,28,43,13,10,3,21,20
01-05-2020 11:00:00,2,2,0,77,38,39,17,13,4,28,26
01-05-2020 12:00:00,10,7,3,102,47,55,33,19,14,42,49
01-05-2020 13:00:00,10,5,5,95,47,48,42,26,16,52,47
01-05-2020 14:00:00,12,4,8,84,37,47,32,20,12,52,40
01-05-2020 15:00:00,10,3,7,75,36,39,30,20,10,35,31
01-05-2020 16:00:00,8,3,5,108,50,58,33,18,15,57,24
01-05-2020 17:00:00,6,5,1,140,64,76,51,39,12,74,43
01-05-2020 18:00:00,3,0,3,129,69,60,27,20,7,54,33
01-05-2020 19:00:00,8,2,6,92,37,55,25,19,6,45,25
01-05-2020 20:00:00,2,1,1,104,48,56,33,22,11,28,20
01-05-2020 21:00:00,6,2,4,55,29,26,25,14,11,20,21
01-05-2020 22:00:00,4,2,2,36,26,10,11,7,4,27,5
01-05-2020 23:00:00,1,0,1,17,10,7,3,3,0,14,3
02-05-2020 00:00:00,0,0,0,7,4,3,1,1,0,1,3
02-05-2020 01:00:00,1,1,0,5,1,4,1,1,0,4,1
02-05-2020 02:00:00,1,0,1,0,0,0,0,0,0,1,4
02-05-2020 03:00:00,0,0,0,2,1,1,0,0,0,0,1
02-05-2020 04:00:00,0,0,0,1,0,1,0,0,0,1,0
02-05-2020 05:00:00,1,0,1,11,2,9,4,3,1,6,1
02-05-2020 06:00:00,2,1,1,18,3,15,6,4,2,8,8
02-05-2020 07:00:00,2,2,0,26,7,19,8,6,2,16,14
02-05-2020 08:00:00,1,1,0,26,9,17,18,15,3,9,20
02-05-2020 09:00:00,5,4,1,57,24,33,19,15,4,26,24
02-05-2020 10:00:00,4,4,0,85,40,45,25,18,7,25,29
02-05-2020 11:00:00,8,7,1,92,35,57,30,20,10,29,19
02-05-2020 12:00:00,5,3,2,113,43,70,25,18,7,47,29
02-05-2020 13:00:00,8,5,3,166,86,80,40,28,12,57,51
02-05-2020 14:00:00,10,6,4,162,60,102,53,31,22,60,73
02-05-2020 15:00:00,7,5,2,179,83,96,48,38,10,55,66
02-05-2020 16:00:00,18,13,5,166,83,83,55,31,24,69,64
02-05-2020 17:00:00,11,4,7,153,59,94,58,32,26,75,72
02-05-2020 18:00:00,6,3,3,161,77,84,39,28,11,55,68
02-05-2020 19:00:00,7,4,3,125,69,56,28,17,11,40,48
02-05-2020 20:00:00,10,5,5,81,45,36,31,19,12,41,23
02-05-2020 21:00:00,5,1,4,50,26,24,24,16,8,24,15
02-05-2020 22:00:00,2,2,0,31,18,13,8,6,2,27,11
02-05-2020 23:00:00,1,1,0,17,11,6,8,5,3,12,9
03-05-2020 00:00:00,1,0,1,8,5,3,3,2,1,6,1
03-05-2020 01:00:00,0,0,0,3,1,2,1,1,0,3,2
03-05-2020 02:00:00,0,0,0,2,1,1,2,0,2,2,0
03-05-2020 03:00:00,1,0,1,0,0,0,1,0,1,0,0
03-05-2020 04:00:00,0,0,0,2,0,2,0,0,0,0,1
03-05-2020 05:00:00,2,1,1,4,1,3,1,1,0,1,1
03-05-2020 06:00:00,0,0,0,13,6,7,3,3,0,6,6
03-05-2020 07:00:00,0,0,0,27,10,17,9,6,3,9,6
03-05-2020 08:00:00,2,2,0,35,11,24,19,17,2,19,14
03-05-2020 09:00:00,3,2,1,58,29,29,16,14,2,16,19
03-05-2020 10:00:00,8,6,2,83,30,53,18,11,7,30,19
03-05-2020 11:00:00,5,2,3,121,40,81,21,11,10,39,33
03-05-2020 12:00:00,9,7,2,144,61,83,48,33,15,66,50
03-05-2020 13:00:00,12,4,8,193,80,113,63,34,29,56,50
03-05-2020 14:00:00,17,11,6,203,94,109,70,43,27,79,87
03-05-2020 15:00:00,7,3,4,169,73,96,68,44,24,89,69
03-05-2020 16:00:00,13,5,8,178,75,103,51,31,20,50,63
03-05-2020 17:00:00,18,11,7,167,93,74,50,35,15,72,60
03-05-2020 18:00:00,12,8,4,126,67,59,59,32,27,48,70
03-05-2020 19:00:00,2,1,1,117,63,54,35,24,11,49,49
03-05-2020 20:00:00,6,4,2,93,45,48,27,18,9,46,36
03-05-2020 21:00:00,1,1,0,61,26,35,22,13,9,21,19
03-05-2020 22:00:00,12,6,6,45,28,17,11,8,3,18,13
03-05-2020 23:00:00,1,1,0,10,7,3,5,3,2,9,5
04-05-2020 00:00:00,1,1,0,5,4,1,2,2,0,6,4
04-05-2020 01:00:00,2,0,2,5,2,3,2,2,0,2,0
04-05-2020 02:00:00,0,0,0,1,0,1,2,0,2,1,0
04-05-2020 03:00:00,0,0,0,1,0,1,0,0,0,1,0
04-05-2020 04:00:00,0,0,0,5,4,1,1,0,1,2,1
04-05-2020 05:00:00,0,0,0,8,0,8,2,1,1,0,4
04-05-2020 06:00:00,2,0,2,12,3,9,8,6,2,6,14
04-05-2020 07:00:00,1,1,0,40,15,25,20,19,1,12,18
04-05-2020 08:00:00,1,1,0,44,16,28,24,21,3,14,15
04-05-2020 09:00:00,4,2,2,66,25,41,24,15,9,20,14
04-05-2020 10:00:00,13,7,6,96,36,60,30,21,9,39,31
04-05-2020 11:00:00,15,8,7,148,65,83,34,24,10,40,25
04-05-2020 12:00:00,5,4,1,161,70,91,42,26,16,42,42
04-05-2020 13:00:00,15,10,5,184,78,106,73,47,26,79,51
04-05-2020 14:00:00,13,9,4,190,74,116,66,36,30,59,85
04-05-2020 15:00:00,11,4,7,183,67,116,63,39,24,72,62
04-05-2020 16:00:00,17,12,5,183,92,91,46,21,25,101,57
04-05-2020 17:00:00,8,0,8,194,104,90,45,30,15,65,86
04-05-2020 18:00:00,2,2,0,147,82,65,56,31,25,53,66
04-05-2020 19:00:00,8,8,0,126,53,73,55,33,22,43,45
04-05-2020 20:00:00,8,5,3,66,33,33,32,19,13,47,32
04-05-2020 21:00:00,3,2,1,62,36,26,26,21,5,20,16
04-05-2020 22:00:00,2,2,0,19,7,12,15,7,8,8,11
04-05-2020 23:00:00,1,1,0,8,3,5,5,3,2,5,9
05-05-2020 00:00:00,2,0,2,3,1,2,3,3,0,4,2
05-05-2020 01:00:00,0,0,0,4,4,0,0,0,0,1,1
05-05-2020 02:00:00,0,0,0,3,2,1,1,0,1,1,0
05-05-2020 03:00:00,0,0,0,1,1,0,1,1,0,0,3
05-05-2020 04:00:00,0,0,0,9,4,5,1,1,0,2,2
05-05-2020 05:00:00,0,0,0,9,2,7,7,6,1,4,11
05-05-2020 06:00:00,0,0,0,34,9,25,16,16,0,13,31
05-05-2020 07:00:00,2,1,1,94,42,52,35,29,6,12,55
05-05-2020 08:00:00,9,7,2,129,52,77,52,45,7,28,80
05-05-2020 09:00:00,3,2,1,77,31,46,13,12,1,20,41
05-05-2020 10:00:00,2,1,1,74,36,38,26,19,7,29,27
05-05-2020 11:00:00,3,1,2,74,37,37,18,12,6,33,40
05-05-2020 12:00:00,5,5,0,81,34,47,25,14,11,44,39
05-05-2020 13:00:00,11,6,5,111,40,71,43,26,17,74,52
05-05-2020 14:00:00,17,11,6,125,44,81,50,26,24,77,53
05-05-2020 15:00:00,17,10,7,118,64,54,61,36,25,81,59
05-05-2020 16:00:00,10,5,5,146,58,88,51,31,20,88,42
05-05-2020 17:00:00,18,11,7,194,87,107,81,50,31,106,45
05-05-2020 18:00:00,14,8,6,184,91,93,53,34,19,87,73
05-05-2020 19:00:00,6,3,3,161,68,93,48,20,28,67,43
05-05-2020 20:00:00,6,2,4,119,63,56,37,24,13,57,16
05-05-2020 21:00:00,7,4,3,46,20,26,26,13,13,34,27
05-05-2020 22:00:00,1,1,0,34,25,9,13,7,6,17,10
05-05-2020 23:00:00,1,0,1,10,6,4,3,3,0,3,4
06-05-2020 00:00:00,,,,4,4,0,,,,,
06-05-2020 01:00:00,,,,2,0,2,,,,,
06-05-2020 02:00:00,,,,0,0,0,,,,,
06-05-2020 03:00:00,,,,2,2,0,,,,,
06-05-2020 04:00:00,,,,10,4,6,,,,,
06-05-2020 05:00:00,,,,9,3,6,0,0,0,,
06-05-2020 06:00:00,,,,47,11,36,,,,,
06-05-2020 07:00:00,,,,102,41,61,,,,,
06-05-2020 08:00:00,,,,141,59,82,,,,,
06-05-2020 09:00:00,,,,94,33,61,,,,,
06-05-2020 10:00:00,,,,64,21,43,,,,,
06-05-2020 11:00:00,,,,83,26,57,,,,,
06-05-2020 12:00:00,,,,129,46,83,,,,,
06-05-2020 13:00:00,,,,127,69,58,,,,,
06-05-2020 14:00:00,7,4,3,148,69,79,0,0,0,11,17
06-05-2020 15:00:00,11,8,3,117,44,73,60,42,18,111,48
06-05-2020 16:00:00,10,2,8,173,70,103,47,28,19,94,49
06-05-2020 17:00:00,20,9,11,205,98,107,64,36,28,102,74
06-05-2020 18:00:00,11,7,4,227,108,119,63,38,25,96,53
06-05-2020 19:00:00,11,4,7,182,96,86,64,43,21,48,60
06-05-2020 20:00:00,15,10,5,104,47,57,40,19,21,52,40
06-05-2020 21:00:00,6,4,2,58,39,19,33,18,15,24,12
06-05-2020 22:00:00,7,4,3,29,23,6,13,9,4,22,11
06-05-2020 23:00:00,0,0,0,16,6,10,2,1,1,6,7
07-05-2020 00:00:00,0,0,0,7,1,6,0,0,0,3,1
07-05-2020 01:00:00,0,0,0,3,2,1,0,0,0,4,0
07-05-2020 02:00:00,0,0,0,2,2,0,1,0,1,1,0
07-05-2020 03:00:00,0,0,0,1,1,0,2,2,0,0,1
07-05-2020 04:00:00,1,0,1,8,3,5,1,1,0,0,3
07-05-2020 05:00:00,0,0,0,17,4,13,4,3,1,5,5
07-05-2020 06:00:00,0,0,0,43,14,29,14,12,2,15,27
07-05-2020 07:00:00,3,2,1,94,39,55,34,25,9,16,56
07-05-2020 08:00:00,1,1,0,151,55,96,44,42,2,24,75
07-05-2020 09:00:00,2,1,1,94,37,57,26,22,4,23,35
07-05-2020 10:00:00,2,2,0,53,21,32,19,13,6,29,25
07-05-2020 11:00:00,4,3,1,72,24,48,22,17,5,30,42
07-05-2020 12:00:00,6,4,2,72,36,36,31,18,13,41,41
07-05-2020 13:00:00,5,4,1,105,40,65,35,30,5,43,37
07-05-2020 14:00:00,15,12,3,106,52,54,33,23,10,54,33
07-05-2020 15:00:00,4,3,1,117,59,58,37,24,13,72,32
07-05-2020 16:00:00,8,2,6,153,80,73,42,22,20,81,56
07-05-2020 17:00:00,15,9,6,173,72,101,63,48,15,106,56
07-05-2020 18:00:00,19,14,5,191,105,86,47,22,25,85,50
07-05-2020 19:00:00,7,3,4,222,94,128,41,31,10,67,55
07-05-2020 20:00:00,5,4,1,112,61,51,38,19,19,62,30
07-05-2020 21:00:00,3,3,0,85,47,38,18,9,9,40,23
07-05-2020 22:00:00,4,1,3,40,22,18,23,12,11,26,29
07-05-2020 23:00:00,3,1,2,22,12,10,7,6,1,14,10
08-05-2020 00:00:00,0,0,0,8,5,3,1,1,0,4,1
08-05-2020 01:00:00,1,1,0,6,4,2,1,0,1,4,3
08-05-2020 02:00:00,0,0,0,1,0,1,0,0,0,1,0
08-05-2020 03:00:00,0,0,0,2,1,1,1,1,0,2,1
08-05-2020 04:00:00,1,0,1,5,3,2,0,0,0,1,0
08-05-2020 05:00:00,0,0,0,14,3,11,8,7,1,3,4
08-05-2020 06:00:00,0,0,0,36,9,27,16,14,2,7,27
08-05-2020 07:00:00,2,2,0,113,46,67,37,24,13,21,50
08-05-2020 08:00:00,3,3,0,150,54,96,42,39,3,23,81
08-05-2020 09:00:00,7,5,2,83,24,59,25,22,3,19,45
08-05-2020 10:00:00,5,3,2,109,39,70,29,20,9,30,29
08-05-2020 11:00:00,7,3,4,106,41,65,44,27,17,52,42
08-05-2020 12:00:00,12,11,1,161,62,99,48,33,15,69,47
08-05-2020 13:00:00,12,4,8,177,79,98,63,31,32,73,46
08-05-2020 14:00:00,15,10,5,144,62,82,73,43,30,87,55
08-05-2020 15:00:00,13,6,7,136,55,81,64,34,30,107,53
08-05-2020 16:00:00,11,5,6,197,87,110,64,34,30,108,59
08-05-2020 17:00:00,10,6,4,229,103,126,80,47,33,112,58
08-05-2020 18:00:00,17,7,10,219,104,115,88,60,28,99,105
08-05-2020 19:00:00,13,5,8,205,111,94,45,27,18,71,70
08-05-2020 20:00:00,15,4,11,126,67,59,44,19,25,59,44
08-05-2020 21:00:00,9,7,2,73,40,33,21,13,8,34,29
08-05-2020 22:00:00,2,2,0,42,27,15,23,11,12,33,17
08-05-2020 23:00:00,0,0,0,25,17,8,4,2,2,17,7
09-05-2020 00:00:00,1,0,1,18,13,5,6,4,2,5,2
09-05-2020 01:00:00,0,0,0,9,5,4,2,1,1,2,2
09-05-2020 02:00:00,0,0,0,2,1,1,1,0,1,2,0
09-05-2020 03:00:00,1,0,1,5,2,3,0,0,0,3,2
09-05-2020 04:00:00,0,0,0,4,1,3,3,2,1,5,2
09-05-2020 05:00:00,0,0,0,9,2,7,3,3,0,11,3
09-05-2020 06:00:00,1,0,1,35,15,20,8,8,0,8,14
09-05-2020 07:00:00,2,1,1,44,19,25,16,13,3,18,19
09-05-2020 08:00:00,1,1,0,45,15,30,21,18,3,14,30
09-05-2020 09:00:00,4,4,0,78,32,46,24,17,7,46,38
09-05-2020 10:00:00,7,3,4,128,44,84,41,32,9,63,49
09-05-2020 11:00:00,11,7,4,198,75,123,68,38,30,99,50
09-05-2020 12:00:00,16,13,3,207,88,119,85,50,35,130,60
09-05-2020 13:00:00,22,16,6,264,84,180,88,59,29,149,93
09-05-2020 14:00:00,22,18,4,250,88,162,116,70,46,141,124
09-05-2020 15:00:00,23,12,11,270,127,143,107,45,62,136,103
09-05-2020 16:00:00,13,3,10,198,90,108,80,55,25,133,120
09-05-2020 17:00:00,19,6,13,210,124,86,73,39,34,116,135
09-05-2020 18:00:00,8,5,3,208,117,91,83,51,32,82,100
09-05-2020 19:00:00,6,2,4,196,100,96,66,40,26,67,87
09-05-2020 20:00:00,15,5,10,141,71,70,44,30,14,57,68
09-05-2020 21:00:00,10,4,6,110,60,50,39,25,14,45,27
09-05-2020 22:00:00,4,2,2,67,40,27,30,14,16,31,16
09-05-2020 23:00:00,1,0,1,20,14,6,10,7,3,16,9
10-05-2020 00:00:00,3,2,1,9,4,5,6,2,4,12,7
10-05-2020 01:00:00,3,2,1,10,4,6,0,0,0,5,6
10-05-2020 02:00:00,3,2,1,4,1,3,6,4,2,1,2
10-05-2020 03:00:00,0,0,0,1,1,0,2,1,1,0,0
10-05-2020 04:00:00,0,0,0,2,2,0,0,0,0,2,1
10-05-2020 05:00:00,0,0,0,6,3,3,0,0,0,0,2
10-05-2020 06:00:00,0,0,0,14,5,9,6,6,0,3,8
10-05-2020 07:00:00,0,0,0,26,10,16,12,9,3,17,12
10-05-2020 08:00:00,2,2,0,44,9,35,19,14,5,10,12
10-05-2020 09:00:00,3,1,2,48,27,21,18,12,6,19,17
10-05-2020 10:00:00,3,0,3,82,34,48,25,12,13,25,29
10-05-2020 11:00:00,5,2,3,86,38,48,29,16,13,25,32
10-05-2020 12:00:00,8,6,2,87,36,51,43,33,10,36,39
10-05-2020 13:00:00,11,5,6,100,48,52,23,13,10,18,36
10-05-2020 14:00:00,3,1,2,70,29,41,20,14,6,50,21
10-05-2020 15:00:00,13,5,8,77,39,38,43,33,10,35,38
10-05-2020 16:00:00,9,8,1,87,40,47,36,31,5,48,21
10-05-2020 17:00:00,8,3,5,90,42,48,23,15,8,37,33
10-05-2020 18:00:00,6,3,3,82,41,41,31,20,11,26,38
10-05-2020 19:00:00,6,3,3,65,39,26,22,18,4,34,28
10-05-2020 20:00:00,2,0,2,61,32,29,28,19,9,32,18
10-05-2020 21:00:00,6,3,3,57,28,29,14,9,5,27,21
10-05-2020 22:00:00,4,2,2,25,19,6,12,6,6,19,6
10-05-2020 23:00:00,0,0,0,10,5,5,2,0,2,9,2
11-05-2020 00:00:00,1,1,0,4,3,1,0,0,0,2,2
11-05-2020 01:00:00,0,0,0,2,2,0,1,0,1,0,1
11-05-2020 02:00:00,0,0,0,0,0,0,0,0,0,0,0
11-05-2020 03:00:00,0,0,0,1,1,0,1,1,0,1,0
11-05-2020 04:00:00,0,0,0,12,6,6,1,1,0,1,1
11-05-2020 05:00:00,0,0,0,10,5,5,4,4,0,1,7
11-05-2020 06:00:00,1,1,0,42,11,31,12,12,0,5,28
11-05-2020 07:00:00,4,3,1,88,34,54,39,32,7,21,57
11-05-2020 08:00:00,6,4,2,133,44,89,47,42,5,18,56
11-05-2020 09:00:00,2,0,2,73,19,54,25,22,3,10,27
11-05-2020 10:00:00,3,1,2,46,13,33,5,2,3,16,24
11-05-2020 11:00:00,7,5,2,57,26,31,14,13,1,28,34
11-05-2020 12:00:00,11,4,7,82,38,44,23,14,9,37,24
11-05-2020 13:00:00,8,2,6,87,37,50,31,22,9,50,45
11-05-2020 14:00:00,8,4,4,107,43,64,25,12,13,47,40
11-05-2020 15:00:00,6,3,3,113,57,56,37,21,16,59,44
11-05-2020 16:00:00,13,9,4,133,65,68,55,32,23,79,51
11-05-2020 17:00:00,7,6,1,181,98,83,46,33,13,96,47
11-05-2020 18:00:00,14,11,3,194,93,101,56,30,26,96,53
11-05-2020 19:00:00,7,3,4,141,66,75,45,24,21,55,40
11-05-2020 20:00:00,6,4,2,104,60,44,36,25,11,38,24
11-05-2020 21:00:00,4,2,2,39,16,23,18,14,4,37,9
11-05-2020 22:00:00,1,1,0,23,8,15,9,5,4,17,11
11-05-2020 23:00:00,1,1,0,16,11,5,2,2,0,5,5
12-05-2020 00:00:00,1,1,0,8,2,6,0,0,0,5,3
12-05-2020 01:00:00,0,0,0,7,3,4,0,0,0,1,0
12-05-2020 02:00:00,0,0,0,0,0,0,0,0,0,1,1
12-05-2020 03:00:00,0,0,0,2,1,1,1,1,0,0,0
12-05-2020 04:00:00,0,0,0,5,3,2,1,1,0,2,4
12-05-2020 05:00:00,1,1,0,18,4,14,5,4,1,5,5
12-05-2020 06:00:00,0,0,0,36,10,26,18,18,0,10,34
12-05-2020 07:00:00,2,2,0,110,46,64,34,26,8,16,51
12-05-2020 08:00:00,11,8,3,136,58,78,50,46,4,22,74
12-05-2020 09:00:00,4,2,2,82,18,64,23,20,3,16,41
12-05-2020 10:00:00,3,2,1,72,43,29,28,20,8,25,31
12-05-2020 11:00:00,10,6,4,79,38,41,31,23,8,39,35
12-05-2020 12:00:00,6,3,3,97,32,65,33,23,10,33,47
12-05-2020 13:00:00,6,1,5,107,51,56,34,17,17,54,50
12-05-2020 14:00:00,6,3,3,94,44,50,36,20,16,46,60
12-05-2020 15:00:00,9,5,4,90,46,44,41,26,15,72,32
12-05-2020 16:00:00,10,8,2,140,66,74,37,17,20,85,41
12-05-2020 17:00:00,11,8,3,186,91,95,53,37,16,115,79
12-05-2020 18:00:00,17,7,10,182,97,85,46,22,24,108,28
12-05-2020 19:00:00,6,4,2,145,59,86,35,19,16,65,30
12-05-2020 20:00:00,6,1,5,101,56,45,39,21,18,52,41
12-05-2020 21:00:00,7,7,0,73,37,36,23,13,10,26,20
12-05-2020 22:00:00,1,1,0,25,18,7,17,7,10,20,8
12-05-2020 23:00:00,0,0,0,10,4,6,6,4,2,12,2
13-05-2020 00:00:00,0,0,0,10,3,7,1,1,0,5,3
13-05-2020 01:00:00,0,0,0,7,7,0,3,0,3,4,1
13-05-2020 02:00:00,0,0,0,0,0,0,1,0,1,1,0
13-05-2020 03:00:00,0,0,0,2,1,1,1,1,0,0,1
13-05-2020 04:00:00,0,0,0,7,4,3,1,1,0,2,4
13-05-2020 05:00:00,2,1,1,13,2,11,7,6,1,3,5
13-05-2020 06:00:00,0,0,0,41,14,27,21,19,2,10,28
13-05-2020 07:00:00,3,2,1,102,39,63,37,28,9,29,72
13-05-2020 08:00:00,9,7,2,127,44,83,50,45,5,15,80
13-05-2020 09:00:00,5,4,1,81,24,57,24,22,2,21,56
13-05-2020 10:00:00,4,2,2,46,19,27,19,11,8,18,44
13-05-2020 11:00:00,3,2,1,78,22,56,21,15,6,50,25
13-05-2020 12:00:00,14,6,8,90,25,65,33,24,9,51,36
13-05-2020 13:00:00,12,6,6,121,38,83,39,23,16,44,35
13-05-2020 14:00:00,7,2,5,99,49,50,38,21,17,50,56
13-05-2020 15:00:00,15,7,8,123,41,82,36,23,13,57,35
13-05-2020 16:00:00,13,8,5,152,77,75,44,22,22,88,42
13-05-2020 17:00:00,14,9,5,210,113,97,69,46,23,120,51
13-05-2020 18:00:00,13,10,3,191,93,98,61,37,24,125,45
13-05-2020 19:00:00,11,5,6,137,73,64,54,29,25,68,46
13-05-2020 20:00:00,7,5,2,48,26,22,48,38,10,48,45
13-05-2020 21:00:00,3,0,3,4,2,2,17,5,12,49,32
13-05-2020 22:00:00,1,0,1,6,4,2,12,9,3,21,10
13-05-2020 23:00:00,0,0,0,17,6,11,5,2,3,6,6
14-05-2020 00:00:00,0,0,0,5,2,3,1,0,1,3,1
14-05-2020 01:00:00,0,0,0,2,2,0,0,0,0,0,1
14-05-2020 02:00:00,0,0,0,3,1,2,2,0,2,0,0
14-05-2020 03:00:00,1,0,1,1,1,0,2,1,1,0,0
14-05-2020 04:00:00,0,0,0,7,1,6,3,1,2,3,1
14-05-2020 05:00:00,3,1,2,12,4,8,4,4,0,2,5
14-05-2020 06:00:00,0,0,0,37,13,24,18,17,1,8,30
14-05-2020 07:00:00,5,4,1,109,41,68,33,24,9,25,59
14-05-2020 08:00:00,5,4,1,127,47,80,47,47,0,24,82
14-05-2020 09:00:00,1,1,0,127,31,96,20,19,1,12,41
14-05-2020 10:00:00,1,1,0,117,32,85,27,20,7,24,27
14-05-2020 11:00:00,3,2,1,99,31,68,34,23,11,36,27
14-05-2020 12:00:00,6,3,3,156,37,119,48,27,21,54,25
14-05-2020 13:00:00,14,7,7,160,46,114,52,35,17,87,58
14-05-2020 14:00:00,8,4,4,139,55,84,41,28,13,83,68
14-05-2020 15:00:00,6,4,2,171,78,93,42,23,19,93,66
14-05-2020 16:00:00,19,15,4,175,86,89,56,31,25,133,56
14-05-2020 17:00:00,17,11,6,229,115,114,66,40,26,126,88
14-05-2020 18:00:00,14,8,6,249,128,121,84,57,27,95,87
14-05-2020 19:00:00,9,2,7,182,78,104,59,32,27,65,85
14-05-2020 20:00:00,6,4,2,127,68,59,63,28,35,52,31
14-05-2020 21:00:00,7,2,5,65,22,43,35,16,19,35,29
14-05-2020 22:00:00,3,1,2,34,24,10,14,6,8,21,10
14-05-2020 23:00:00,0,0,0,20,7,13,9,6,3,11,8
15-05-2020 00:00:00,0,0,0,13,8,5,2,0,2,8,1
15-05-2020 01:00:00,0,0,0,4,1,3,2,0,2,1,2
15-05-2020 02:00:00,1,1,0,1,1,0,0,0,0,0,0
15-05-2020 03:00:00,0,0,0,1,1,0,1,0,1,2,0
15-05-2020 04:00:00,2,2,0,6,3,3,1,1,0,3,4
15-05-2020 05:00:00,3,2,1,12,4,8,4,4,0,2,8
15-05-2020 06:00:00,0,0,0,40,11,29,12,11,1,12,34
15-05-2020 07:00:00,1,1,0,97,28,69,49,38,11,19,64
15-05-2020 08:00:00,8,7,1,144,51,93,48,44,4,22,93
15-05-2020 09:00:00,6,2,4,86,32,54,30,27,3,12,37
15-05-2020 10:00:00,13,10,3,73,31,42,18,15,3,17,31
15-05-2020 11:00:00,6,3,3,80,32,48,27,22,5,31,33
15-05-2020 12:00:00,3,1,2,106,40,66,27,19,8,57,46
15-05-2020 13:00:00,5,1,4,139,61,78,38,26,12,68,54
15-05-2020 14:00:00,7,5,2,114,52,62,45,18,27,64,55
15-05-2020 15:00:00,11,7,4,116,52,64,37,18,19,61,37
15-05-2020 16:00:00,16,9,7,150,77,73,52,34,18,77,53
15-05-2020 17:00:00,14,7,7,186,96,90,55,37,18,128,76
15-05-2020 18:00:00,14,8,6,181,92,89,53,32,21,102,53
15-05-2020 19:00:00,11,7,4,140,75,65,48,31,17,61,28
15-05-2020 20:00:00,12,9,3,111,52,59,31,23,8,48,55
15-05-2020 21:00:00,5,2,3,80,37,43,36,23,13,28,25
15-05-2020 22:00:00,2,1,1,46,32,14,21,13,8,23,15
15-05-2020 23:00:00,1,0,1,23,10,13,9,6,3,12,11
16-05-2020 00:00:00,0,0,0,16,10,6,4,2,2,6,4
16-05-2020 01:00:00,1,0,1,9,3,6,3,1,2,5,2
16-05-2020 02:00:00,0,0,0,2,1,1,1,1,0,2,0
16-05-2020 03:00:00,0,0,0,3,2,1,0,0,0,0,0
16-05-2020 04:00:00,0,0,0,1,1,0,3,2,1,1,0
16-05-2020 05:00:00,0,0,0,13,2,11,6,6,0,6,8
16-05-2020 06:00:00,0,0,0,24,5,19,8,7,1,8,10
16-05-2020 07:00:00,1,1,0,53,20,33,14,14,0,16,23
16-05-2020 08:00:00,4,3,1,55,20,35,22,20,2,19,26
16-05-2020 09:00:00,3,2,1,71,26,45,27,20,7,38,30
16-05-2020 10:00:00,2,2,0,106,37,69,31,21,10,37,41
16-05-2020 11:00:00,9,7,2,124,53,71,65,42,23,68,61
16-05-2020 12:00:00,7,5,2,156,61,95,51,31,20,89,67
16-05-2020 13:00:00,13,7,6,223,93,130,101,60,41,80,67
16-05-2020 14:00:00,13,9,4,219,102,117,83,52,31,105,106
16-05-2020 15:00:00,9,7,2,270,113,157,79,56,23,100,121
16-05-2020 16:00:00,16,12,4,204,88,116,83,52,31,120,73
16-05-2020 17:00:00,14,9,5,205,108,97,60,36,24,77,95
16-05-2020 18:00:00,11,6,5,175,85,90,63,37,26,70,85
16-05-2020 19:00:00,11,3,8,139,70,69,44,28,16,48,61
16-05-2020 20:00:00,4,2,2,116,61,55,39,24,15,61,52
16-05-2020 21:00:00,5,0,5,74,37,37,29,18,11,32,39
16-05-2020 22:00:00,5,4,1,53,35,18,24,8,16,36,23
16-05-2020 23:00:00,2,1,1,21,11,10,7,5,2,21,11
17-05-2020 00:00:00,2,0,2,18,5,13,7,6,1,10,2
17-05-2020 01:00:00,0,0,0,12,10,2,1,1,0,5,2
17-05-2020 02:00:00,2,0,2,4,3,1,0,0,0,6,2
17-05-2020 03:00:00,0,0,0,0,0,0,1,1,0,1,0
17-05-2020 04:00:00,0,0,0,2,1,1,1,1,0,0,2
17-05-2020 05:00:00,0,0,0,8,4,4,1,1,0,4,3
17-05-2020 06:00:00,2,1,1,17,7,10,8,5,3,6,11
17-05-2020 07:00:00,1,1,0,32,11,21,11,8,3,18,10
17-05-2020 08:00:00,2,2,0,33,12,21,17,15,2,19,23
17-05-2020 09:00:00,9,5,4,58,19,39,34,21,13,26,32
17-05-2020 10:00:00,6,5,1,101,42,59,20,12,8,38,39
17-05-2020 11:00:00,10,3,7,97,35,62,40,27,13,65,32
17-05-2020 12:00:00,10,5,5,133,46,87,57,31,26,82,49
17-05-2020 13:00:00,15,10,5,176,74,102,74,39,35,77,68
17-05-2020 14:00:00,19,13,6,193,76,117,78,40,38,102,84
17-05-2020 15:00:00,12,8,4,190,72,118,86,60,26,103,83
17-05-2020 16:00:00,12,6,6,178,83,95,78,47,31,77,89
17-05-2020 17:00:00,6,4,2,142,70,72,64,43,21,71,84
17-05-2020 18:00:00,12,5,7,159,77,82,60,36,24,67,80
17-05-2020 19:00:00,10,3,7,114,54,60,47,25,22,53,50
17-05-2020 20:00:00,10,5,5,86,40,46,38,21,17,60,42
17-05-2020 21:00:00,3,3,0,68,36,32,27,14,13,22,19
17-05-2020 22:00:00,2,1,1,44,33,11,20,10,10,38,13
17-05-2020 23:00:00,1,0,1,8,5,3,4,2,2,15,6
18-05-2020 00:00:00,2,1,1,12,5,7,0,0,0,1,4
18-05-2020 01:00:00,1,1,0,3,3,0,0,0,0,2,1
18-05-2020 02:00:00,2,0,2,0,0,0,0,0,0,1,3
18-05-2020 03:00:00,0,0,0,2,2,0,1,1,0,1,0
18-05-2020 04:00:00,0,0,0,9,6,3,0,0,0,1,3
18-05-2020 05:00:00,1,0,1,12,4,8,4,4,0,4,12
18-05-2020 06:00:00,2,1,1,49,14,35,28,24,4,17,39
18-05-2020 07:00:00,6,5,1,113,44,69,53,44,9,21,72
18-05-2020 08:00:00,4,4,0,138,42,96,50,47,3,24,78
18-05-2020 09:00:00,1,1,0,73,19,54,31,28,3,12,36
18-05-2020 10:00:00,6,5,1,65,29,36,18,14,4,12,21
18-05-2020 11:00:00,8,3,5,83,31,52,15,12,3,28,31
18-05-2020 12:00:00,5,2,3,80,34,46,28,22,6,37,39
18-05-2020 13:00:00,3,1,2,94,37,57,42,34,8,40,37
18-05-2020 14:00:00,7,4,3,75,42,33,14,9,5,37,33
18-05-2020 15:00:00,2,2,0,91,43,48,29,15,14,61,14
18-05-2020 16:00:00,9,4,5,122,59,63,34,23,11,78,28
18-05-2020 17:00:00,7,4,3,193,91,102,55,29,26,105,49
18-05-2020 18:00:00,2,1,1,165,89,76,42,28,14,91,58
18-05-2020 19:00:00,9,2,7,133,65,68,34,20,14,50,35
18-05-2020 20:00:00,3,2,1,104,55,49,34,17,17,32,29
18-05-2020 21:00:00,8,5,3,72,26,46,21,13,8,32,16
18-05-2020 22:00:00,7,3,4,35,23,12,9,4,5,17,7
18-05-2020 23:00:00,2,0,2,17,10,7,5,3,2,9,14
19-05-2020 00:00:00,0,0,0,6,3,3,2,2,0,5,1
19-05-2020 01:00:00,1,0,1,7,5,2,2,0,2,1,5
19-05-2020 02:00:00,0,0,0,3,2,1,0,0,0,0,0
19-05-2020 03:00:00,0,0,0,4,2,2,1,1,0,0,0
19-05-2020 04:00:00,0,0,0,12,5,7,0,0,0,0,4
19-05-2020 05:00:00,1,0,1,11,4,7,3,3,0,5,7
19-05-2020 06:00:00,1,1,0,56,14,42,32,30,2,12,49
19-05-2020 07:00:00,5,4,1,138,53,85,59,49,10,27,85
19-05-2020 08:00:00,3,3,0,154,53,101,52,52,0,22,89
19-05-2020 09:00:00,4,3,1,92,27,65,31,28,3,14,56
19-05-2020 10:00:00,7,4,3,66,22,44,29,20,9,23,35
19-05-2020 11:00:00,6,4,2,84,31,53,28,22,6,41,47
19-05-2020 12:00:00,5,2,3,137,52,85,36,24,12,57,36
19-05-2020 13:00:00,6,3,3,148,67,81,44,34,10,57,43
19-05-2020 14:00:00,18,13,5,148,55,93,60,38,22,74,44
19-05-2020 15:00:00,6,4,2,130,50,80,65,31,34,107,52
19-05-2020 16:00:00,10,7,3,215,104,111,83,52,31,139,71
19-05-2020 17:00:00,16,9,7,290,137,153,86,54,32,157,71
19-05-2020 18:00:00,15,10,5,281,137,144,87,59,28,116,77
19-05-2020 19:00:00,20,14,6,213,96,117,83,51,32,92,101
19-05-2020 20:00:00,8,3,5,170,83,87,54,22,32,44,71
19-05-2020 21:00:00,6,1,5,103,66,37,36,19,17,35,37
19-05-2020 22:00:00,3,2,1,42,30,12,21,12,9,27,21
19-05-2020 23:00:00,1,0,1,32,14,18,4,2,2,20,9
20-05-2020 00:00:00,0,0,0,11,6,5,1,1,0,3,2
20-05-2020 01:00:00,0,0,0,7,7,0,0,0,0,2,2
20-05-2020 02:00:00,0,0,0,3,2,1,0,0,0,1,0
20-05-2020 03:00:00,0,0,0,2,1,1,2,2,0,2,1
20-05-2020 04:00:00,0,0,0,7,3,4,3,3,0,4,5
20-05-2020 05:00:00,1,0,1,14,6,8,5,4,1,5,2
20-05-2020 06:00:00,4,4,0,65,12,53,48,42,6,13,63
20-05-2020 07:00:00,6,4,2,146,53,93,66,59,7,30,90
20-05-2020 08:00:00,2,2,0,176,63,113,70,65,5,32,107
20-05-2020 09:00:00,5,4,1,96,38,58,30,24,6,30,68
20-05-2020 10:00:00,6,3,3,97,30,67,35,20,15,52,38
20-05-2020 11:00:00,17,13,4,102,46,56,49,40,9,72,61
20-05-2020 12:00:00,30,18,12,178,62,116,70,39,31,109,73
20-05-2020 13:00:00,8,6,2,194,64,130,92,56,36,149,76
20-05-2020 14:00:00,18,8,10,183,78,105,55,38,17,129,89
20-05-2020 15:00:00,7,4,3,185,83,102,57,31,26,118,65
20-05-2020 16:00:00,24,16,8,241,128,113,65,33,32,159,110
20-05-2020 17:00:00,20,8,12,315,152,163,122,64,58,191,91
20-05-2020 18:00:00,16,9,7,328,145,183,125,70,55,143,97
20-05-2020 19:00:00,18,13,5,219,111,108,81,45,36,92,126
20-05-2020 20:00:00,19,10,9,190,113,77,77,46,31,45,63
20-05-2020 21:00:00,9,5,4,127,73,54,42,25,17,52,39
20-05-2020 22:00:00,9,6,3,65,44,21,20,9,11,32,18
20-05-2020 23:00:00,2,1,1,29,10,19,15,6,9,17,11
21-05-2020 00:00:00,1,0,1,13,8,5,2,2,0,7,4
21-05-2020 01:00:00,0,0,0,6,4,2,1,0,1,2,3
21-05-2020 02:00:00,0,0,0,1,1,0,0,0,0,3,0
21-05-2020 03:00:00,0,0,0,1,0,1,2,2,0,2,0
21-05-2020 04:00:00,2,1,1,9,2,7,0,0,0,2,2
21-05-2020 05:00:00,0,0,0,15,3,12,5,5,0,2,7
21-05-2020 06:00:00,3,3,0,59,11,48,37,35,2,19,43
21-05-2020 07:00:00,2,1,1,136,54,82,56,45,11,15,69
21-05-2020 08:00:00,5,5,0,140,48,92,67,64,3,26,108
21-05-2020 09:00:00,6,4,2,117,33,84,31,27,4,21,65
21-05-2020 10:00:00,13,10,3,75,28,47,30,22,8,34,42
21-05-2020 11:00:00,5,3,2,110,48,62,33,23,10,48,34
21-05-2020 12:00:00,7,6,1,143,53,90,38,24,14,55,66
21-05-2020 13:00:00,5,1,4,145,66,79,45,30,15,73,61
21-05-2020 14:00:00,17,14,3,142,66,76,67,43,24,76,67
21-05-2020 15:00:00,8,4,4,134,78,56,60,32,28,68,57
21-05-2020 16:00:00,13,6,7,203,111,92,55,32,23,126,60
21-05-2020 17:00:00,15,7,8,216,120,96,74,45,29,153,63
21-05-2020 18:00:00,7,6,1,176,87,89,76,48,28,110,43
21-05-2020 19:00:00,12,5,7,183,94,89,30,20,10,61,46
21-05-2020 20:00:00,4,1,3,95,42,53,61,32,29,51,48
21-05-2020 21:00:00,4,3,1,68,38,30,25,19,6,29,20
21-05-2020 22:00:00,2,1,1,32,17,15,13,5,8,30,15
21-05-2020 23:00:00,1,1,0,12,7,5,3,2,1,11,11
22-05-2020 00:00:00,0,0,0,10,2,8,1,1,0,4,3
22-05-2020 01:00:00,2,0,2,3,1,2,1,1,0,3,2
22-05-2020 02:00:00,0,0,0,5,1,4,1,0,1,2,1
22-05-2020 03:00:00,0,0,0,0,0,0,0,0,0,1,1
22-05-2020 04:00:00,0,0,0,7,3,4,1,1,0,0,2
22-05-2020 05:00:00,0,0,0,17,5,12,3,3,0,3,8
22-05-2020 06:00:00,3,3,0,51,9,42,36,32,4,10,41
22-05-2020 07:00:00,4,4,0,91,27,64,49,39,10,15,59
22-05-2020 08:00:00,6,6,0,114,27,87,56,52,4,19,73
22-05-2020 09:00:00,4,3,1,61,16,45,24,18,6,14,35
22-05-2020 10:00:00,7,6,1,60,17,43,14,11,3,20,21
22-05-2020 11:00:00,5,4,1,47,19,28,28,22,6,21,24
22-05-2020 12:00:00,11,5,6,80,37,43,30,23,7,33,22
22-05-2020 13:00:00,3,0,3,93,42,51,40,26,14,38,27
22-05-2020 14:00:00,6,4,2,84,40,44,28,18,10,49,25
22-05-2020 15:00:00,8,6,2,83,35,48,28,19,9,44,25
22-05-2020 16:00:00,5,4,1,90,47,43,43,21,22,74,38
22-05-2020 17:00:00,9,5,4,141,77,64,46,31,15,79,41
22-05-2020 18:00:00,5,4,1,133,64,69,49,32,17,66,33
22-05-2020 19:00:00,11,4,7,103,50,53,43,27,16,73,58
22-05-2020 20:00:00,6,2,4,87,43,44,44,21,23,41,37
22-05-2020 21:00:00,3,2,1,77,40,37,28,18,10,29,24
22-05-2020 22:00:00,7,5,2,42,29,13,25,13,12,24,15
22-05-2020 23:00:00,1,1,0,18,8,10,14,8,6,16,5
23-05-2020 00:00:00,0,0,0,14,9,5,1,1,0,2,2
23-05-2020 01:00:00,0,0,0,6,4,2,4,3,1,1,0
23-05-2020 02:00:00,0,0,0,2,2,0,3,2,1,2,4
23-05-2020 03:00:00,0,0,0,2,1,1,1,1,0,1,1
23-05-2020 04:00:00,0,0,0,3,1,2,0,0,0,1,2
23-05-2020 05:00:00,0,0,0,7,2,5,2,2,0,3,4
23-05-2020 06:00:00,0,0,0,20,7,13,13,12,1,10,12
23-05-2020 07:00:00,0,0,0,43,14,29,7,5,2,12,17
23-05-2020 08:00:00,3,2,1,47,16,31,15,15,0,8,16
23-05-2020 09:00:00,3,2,1,49,18,31,16,14,2,19,23
23-05-2020 10:00:00,12,2,10,69,37,32,19,12,7,19,17
23-05-2020 11:00:00,2,0,2,81,35,46,32,23,9,37,28
23-05-2020 12:00:00,4,3,1,79,25,54,34,25,9,42,40
23-05-2020 13:00:00,3,2,1,123,55,68,46,25,21,51,39
23-05-2020 14:00:00,5,3,2,109,41,68,50,29,21,46,51
23-05-2020 15:00:00,7,5,2,100,45,55,34,27,7,51,33
23-05-2020 16:00:00,12,6,6,98,51,47,40,24,16,70,53
23-05-2020 17:00:00,12,9,3,102,49,53,43,29,14,42,43
23-05-2020 18:00:00,12,7,5,113,62,51,39,28,11,60,48
23-05-2020 19:00:00,2,1,1,90,51,39,44,24,20,50,52
23-05-2020 20:00:00,7,5,2,87,43,44,21,12,9,36,28
23-05-2020 21:00:00,3,2,1,52,33,19,14,9,5,30,19
23-05-2020 22:00:00,3,2,1,46,30,16,11,5,6,11,10
23-05-2020 23:00:00,1,1,0,23,12,11,10,8,2,10,9
24-05-2020 00:00:00,1,0,1,17,8,9,4,3,1,9,4
24-05-2020 01:00:00,2,1,1,10,5,5,1,1,0,3,1
24-05-2020 02:00:00,1,1,0,4,0,4,0,0,0,3,1
24-05-2020 03:00:00,0,0,0,2,2,0,1,1,0,0,1
24-05-2020 04:00:00,0,0,0,3,1,2,0,0,0,1,0
24-05-2020 05:00:00,2,1,1,7,1,6,2,2,0,2,3
24-05-2020 06:00:00,1,0,1,11,2,9,10,9,1,8,12
24-05-2020 07:00:00,1,1,0,26,9,17,5,4,1,12,12
24-05-2020 08:00:00,0,0,0,39,10,29,17,16,1,16,15
24-05-2020 09:00:00,3,2,1,44,16,28,15,11,4,27,14
24-05-2020 10:00:00,7,5,2,101,40,61,39,24,15,27,21
24-05-2020 11:00:00,5,4,1,137,55,82,47,35,12,63,44
24-05-2020 12:00:00,21,13,8,172,69,103,64,36,28,88,65
24-05-2020 13:00:00,8,6,2,217,68,149,86,41,45,133,88
24-05-2020 14:00:00,18,14,4,279,98,181,84,60,24,138,94
24-05-2020 15:00:00,21,17,4,259,113,146,107,76,31,131,95
24-05-2020 16:00:00,14,7,7,248,115,133,95,45,50,139,107
24-05-2020 17:00:00,21,11,10,220,104,116,99,57,42,127,111
24-05-2020 18:00:00,14,2,12,235,127,108,80,45,35,81,117
24-05-2020 19:00:00,15,9,6,170,100,70,57,37,20,70,97
24-05-2020 20:00:00,18,9,9,158,78,80,62,40,22,70,78
24-05-2020 21:00:00,21,8,13,94,57,37,57,23,34,65,71
24-05-2020 22:00:00,8,3,5,57,32,25,30,15,15,39,18
24-05-2020 23:00:00,5,2,3,38,25,13,6,4,2,22,11
25-05-2020 00:00:00,0,0,0,13,10,3,4,4,0,6,9
25-05-2020 01:00:00,0,0,0,4,3,1,3,2,1,5,1
25-05-2020 02:00:00,0,0,0,3,0,3,0,0,0,1,0
25-05-2020 03:00:00,0,0,0,6,3,3,0,0,0,1,0
25-05-2020 04:00:00,1,0,1,6,3,3,1,1,0,0,2
25-05-2020 05:00:00,1,1,0,10,6,4,7,7,0,3,14
25-05-2020 06:00:00,2,2,0,80,18,62,51,48,3,14,59
25-05-2020 07:00:00,2,2,0,137,42,95,58,47,11,26,76
25-05-2020 08:00:00,5,4,1,157,51,106,74,70,4,31,96
25-05-2020 09:00:00,3,3,0,107,27,80,33,26,7,25,67
25-05-2020 10:00:00,5,3,2,91,33,58,21,17,4,37,37
25-05-2020 11:00:00,5,3,2,115,54,61,39,25,14,41,50
25-05-2020 12:00:00,10,7,3,166,66,100,51,37,14,72,54
25-05-2020 13:00:00,14,9,5,163,63,100,60,39,21,83,65
25-05-2020 14:00:00,16,11,5,167,62,105,76,52,24,103,48
25-05-2020 15:00:00,12,8,4,183,70,113,71,32,39,92,78
25-05-2020 16:00:00,18,8,10,178,96,82,77,37,40,129,93
25-05-2020 17:00:00,13,10,3,268,161,107,108,49,59,133,94
25-05-2020 18:00:00,10,6,4,223,116,107,85,53,32,116,74
25-05-2020 19:00:00,21,7,14,158,78,80,61,35,26,79,52
25-05-2020 20:00:00,13,5,8,103,53,50,53,28,25,53,38
25-05-2020 21:00:00,6,3,3,78,43,35,31,24,7,31,30
25-05-2020 22:00:00,7,6,1,41,21,20,20,12,8,28,12
25-05-2020 23:00:00,5,2,3,20,9,11,10,5,5,15,5
26-05-2020 00:00:00,0,0,0,15,9,6,2,1,1,4,3
26-05-2020 01:00:00,0,0,0,6,4,2,1,0,1,1,2
26-05-2020 02:00:00,0,0,0,1,0,1,0,0,0,0,1
26-05-2020 03:00:00,0,0,0,1,1,0,1,1,0,2,0
26-05-2020 04:00:00,0,0,0,9,3,6,0,0,0,1,2
26-05-2020 05:00:00,2,1,1,15,8,7,10,9,1,5,14
26-05-2020 06:00:00,3,2,1,86,20,66,70,61,9,19,64
26-05-2020 07:00:00,5,4,1,143,41,102,73,58,15,24,94
26-05-2020 08:00:00,5,5,0,178,59,119,60,59,1,25,115
26-05-2020 09:00:00,5,3,2,112,34,78,43,39,4,28,60
26-05-2020 10:00:00,12,6,6,99,28,71,32,18,14,35,45
26-05-2020 11:00:00,3,3,0,114,49,65,32,20,12,68,36
26-05-2020 12:00:00,9,8,1,150,42,108,51,33,18,101,54
26-05-2020 13:00:00,25,14,11,151,65,86,60,32,28,107,52
26-05-2020 14:00:00,11,7,4,169,80,89,56,36,20,118,35
26-05-2020 15:00:00,6,3,3,149,80,69,54,33,21,125,66
26-05-2020 16:00:00,17,10,7,187,94,93,86,50,36,136,85
26-05-2020 17:00:00,7,2,5,237,130,107,94,51,43,163,99
26-05-2020 18:00:00,16,7,9,236,106,130,89,51,38,157,79
26-05-2020 19:00:00,17,7,10,182,91,91,50,33,17,87,82
26-05-2020 20:00:00,14,5,9,128,77,51,45,22,23,55,33
26-05-2020 21:00:00,6,3,3,88,50,38,38,20,18,66,22
26-05-2020 22:00:00,10,8,2,50,27,23,24,12,12,13,15
26-05-2020 23:00:00,0,0,0,24,14,10,10,5,5,19,2
27-05-2020 00:00:00,1,0,1,5,3,2,4,3,1,6,5
27-05-2020 01:00:00,2,1,1,5,2,3,0,0,0,4,4
27-05-2020 02:00:00,0,0,0,3,1,2,2,1,1,3,1
27-05-2020 03:00:00,0,0,0,2,1,1,1,1,0,1,0
27-05-2020 04:00:00,1,0,1,10,4,6,0,0,0,4,6
27-05-2020 05:00:00,0,0,0,12,2,10,5,5,0,5,13
27-05-2020 06:00:00,5,2,3,79,12,67,66,60,6,17,70
27-05-2020 07:00:00,3,2,1,167,44,123,62,50,12,31,102
27-05-2020 08:00:00,3,3,0,179,59,120,70,63,7,35,109
27-05-2020 09:00:00,9,7,2,110,30,80,38,33,5,29,57
27-05-2020 10:00:00,7,5,2,103,38,65,32,27,5,44,44
27-05-2020 11:00:00,5,4,1,124,53,71,40,31,9,48,43
27-05-2020 12:00:00,14,7,7,157,56,101,55,32,23,74,55
27-05-2020 13:00:00,12,6,6,182,81,101,71,51,20,89,73
27-05-2020 14:00:00,8,5,3,159,59,100,75,51,24,96,61
27-05-2020 15:00:00,12,8,4,174,82,92,71,41,30,126,50
27-05-2020 16:00:00,13,11,2,224,114,110,76,30,46,132,68
27-05-2020 17:00:00,16,6,10,322,160,162,130,73,57,172,88
27-05-2020 18:00:00,13,7,6,254,147,107,108,57,51,152,71
27-05-2020 19:00:00,19,10,9,216,111,105,80,39,41,103,87
27-05-2020 20:00:00,8,4,4,188,99,89,59,34,25,68,57
27-05-2020 21:00:00,13,8,5,111,62,49,46,25,21,48,40
27-05-2020 22:00:00,9,7,2,46,33,13,30,16,14,43,19
27-05-2020 23:00:00,3,0,3,22,15,7,12,9,3,13,7
28-05-2020 00:00:00,0,0,0,11,4,7,5,2,3,12,2
28-05-2020 01:00:00,1,0,1,3,3,0,1,1,0,1,4
28-05-2020 02:00:00,0,0,0,1,1,0,1,0,1,1,0
28-05-2020 03:00:00,0,0,0,3,3,0,2,1,1,1,0
28-05-2020 04:00:00,1,0,1,8,3,5,1,1,0,0,5
28-05-2020 05:00:00,1,1,0,14,7,7,7,6,1,6,7
28-05-2020 06:00:00,2,1,1,87,15,72,58,54,4,18,66
28-05-2020 07:00:00,8,4,4,167,48,119,69,54,15,32,96
28-05-2020 08:00:00,6,5,1,132,7,125,62,58,4,33,89
28-05-2020 09:00:00,9,7,2,90,0,90,36,31,5,30,46
28-05-2020 10:00:00,6,3,3,73,3,70,42,33,9,64,31
28-05-2020 11:00:00,13,8,5,138,41,97,38,26,12,86,43
28-05-2020 12:00:00,4,2,2,155,61,94,53,36,17,94,53
28-05-2020 13:00:00,7,7,0,212,70,142,83,61,22,140,59
28-05-2020 14:00:00,21,15,6,185,65,120,71,36,35,121,76
28-05-2020 15:00:00,26,19,7,166,77,89,91,54,37,115,70
28-05-2020 16:00:00,16,7,9,258,138,120,124,75,49,142,103
28-05-2020 17:00:00,19,14,5,320,183,137,124,62,62,201,105
28-05-2020 18:00:00,14,5,9,305,148,157,83,48,35,144,68
28-05-2020 19:00:00,18,4,14,240,120,120,107,54,53,113,126
28-05-2020 20:00:00,9,4,5,179,97,82,63,33,30,67,103
28-05-2020 21:00:00,9,6,3,151,90,61,44,23,21,41,49
28-05-2020 22:00:00,6,4,2,82,49,33,42,18,24,30,19
28-05-2020 23:00:00,2,0,2,38,29,9,14,7,7,14,6
29-05-2020 00:00:00,1,0,1,16,11,5,7,2,5,10,3
29-05-2020 01:00:00,0,0,0,10,6,4,0,0,0,2,0
29-05-2020 02:00:00,1,1,0,8,3,5,2,0,2,4,0
29-05-2020 03:00:00,0,0,0,7,5,2,2,1,1,4,0
29-05-2020 04:00:00,1,0,1,14,6,8,3,3,0,6,1
29-05-2020 05:00:00,0,0,0,15,6,9,9,9,0,8,9
29-05-2020 06:00:00,3,3,0,92,15,77,49,46,3,16,65
29-05-2020 07:00:00,5,4,1,155,52,103,62,50,12,25,60
29-05-2020 08:00:00,11,8,3,180,65,115,58,52,6,38,98
29-05-2020 09:00:00,10,6,4,104,36,68,49,39,10,37,62
29-05-2020 10:00:00,10,7,3,98,25,73,33,24,9,58,38
29-05-2020 11:00:00,13,12,1,129,51,78,44,36,8,73,43
29-05-2020 12:00:00,17,13,4,176,67,109,56,35,21,90,53
29-05-2020 13:00:00,10,8,2,196,71,125,67,39,28,98,78
29-05-2020 14:00:00,12,9,3,184,75,109,85,54,31,137,51
29-05-2020 15:00:00,25,12,13,204,100,104,103,65,38,125,66
29-05-2020 16:00:00,25,12,13,245,102,143,88,41,47,154,89
29-05-2020 17:00:00,25,12,13,271,130,141,94,65,29,173,125
29-05-2020 18:00:00,21,12,9,287,139,148,95,48,47,141,97
29-05-2020 19:00:00,15,10,5,249,131,118,70,45,25,102,101
29-05-2020 20:00:00,13,6,7,183,100,83,75,43,32,69,93
29-05-2020 21:00:00,11,8,3,139,82,57,49,21,28,64,63
29-05-2020 22:00:00,5,1,4,87,52,35,26,12,14,38,23
29-05-2020 23:00:00,6,1,5,47,30,17,25,10,15,29,14
30-05-2020 00:00:00,4,3,1,23,8,15,9,3,6,22,9
30-05-2020 01:00:00,0,0,0,19,7,12,8,2,6,3,4
30-05-2020 02:00:00,1,0,1,8,5,3,3,3,0,6,4
30-05-2020 03:00:00,0,0,0,3,3,0,0,0,0,3,4
30-05-2020 04:00:00,0,0,0,7,3,4,3,3,0,0,2
30-05-2020 05:00:00,2,2,0,16,6,10,2,2,0,7,6
30-05-2020 06:00:00,0,0,0,34,9,25,15,14,1,14,13
30-05-2020 07:00:00,1,1,0,55,20,35,29,26,3,16,27
30-05-2020 08:00:00,5,3,2,67,19,48,29,29,0,28,29
30-05-2020 09:00:00,7,4,3,131,49,82,24,18,6,42,42
30-05-2020 10:00:00,12,6,6,138,50,88,46,29,17,73,38
30-05-2020 11:00:00,24,17,7,212,83,129,74,51,23,108,60
30-05-2020 12:00:00,11,6,5,187,68,119,87,56,31,153,101
30-05-2020 13:00:00,17,11,6,266,106,160,87,49,38,138,82
30-05-2020 14:00:00,16,9,7,262,111,151,113,72,41,138,93
30-05-2020 15:00:00,17,8,9,247,86,161,97,68,29,151,99
30-05-2020 16:00:00,11,8,3,251,121,130,70,42,28,147,106
30-05-2020 17:00:00,7,3,4,237,112,125,88,50,38,108,117
30-05-2020 18:00:00,14,7,7,247,123,124,87,49,38,94,138
30-05-2020 19:00:00,17,6,11,224,121,103,86,46,40,81,100
30-05-2020 20:00:00,12,8,4,171,88,83,53,36,17,74,104
30-05-2020 21:00:00,12,5,7,130,74,56,26,16,10,56,78
30-05-2020 22:00:00,11,5,6,98,60,38,52,28,24,47,41
30-05-2020 23:00:00,3,3,0,67,41,26,24,14,10,32,22
31-05-2020 00:00:00,3,0,3,32,23,9,12,7,5,12,8
31-05-2020 01:00:00,0,0,0,16,9,7,7,1,6,12,10
31-05-2020 02:00:00,0,0,0,12,6,6,2,0,2,5,4
31-05-2020 03:00:00,0,0,0,5,5,0,1,1,0,1,7
31-05-2020 04:00:00,0,0,0,10,5,5,0,0,0,3,2
31-05-2020 05:00:00,0,0,0,11,4,7,2,1,1,4,1
31-05-2020 06:00:00,1,1,0,22,5,17,12,10,2,11,12
31-05-2020 07:00:00,3,3,0,42,15,27,13,11,2,24,22
31-05-2020 08:00:00,1,1,0,54,25,29,15,14,1,28,27
31-05-2020 09:00:00,5,4,1,94,40,54,33,21,12,36,23
31-05-2020 10:00:00,15,9,6,152,45,107,49,37,12,79,54
31-05-2020 11:00:00,13,6,7,195,76,119,48,32,16,95,52
31-05-2020 12:00:00,16,14,2,230,103,127,118,71,47,99,87
31-05-2020 13:00:00,28,17,11,260,94,166,112,73,39,150,80
31-05-2020 14:00:00,18,9,9,262,94,168,119,71,48,157,128
31-05-2020 15:00:00,11,8,3,318,122,196,99,50,49,152,109
31-05-2020 16:00:00,20,12,8,219,102,117,103,56,47,126,108
31-05-2020 17:00:00,16,4,12,249,134,115,70,46,24,92,142
31-05-2020 18:00:00,12,6,6,209,107,102,67,44,23,84,116
31-05-2020 19:00:00,9,7,2,177,94,83,74,42,32,94,136
31-05-2020 20:00:00,13,4,9,141,83,58,67,41,26,59,87
31-05-2020 21:00:00,8,6,2,118,63,55,50,24,26,58,71
31-05-2020 22:00:00,8,4,4,82,43,39,45,25,20,41,36
31-05-2020 23:00:00,4,2,2,34,17,17,20,5,15,17,14
01-06-2020 00:00:00,0,0,0,19,13,6,4,2,2,2,9
01-06-2020 01:00:00,1,0,1,11,5,6,2,0,2,8,3
01-06-2020 02:00:00,0,0,0,11,8,3,3,1,2,7,1
01-06-2020 03:00:00,0,0,0,4,3,1,0,0,0,1,2
01-06-2020 04:00:00,0,0,0,11,3,8,1,0,1,8,4
01-06-2020 05:00:00,0,0,0,13,3,10,0,0,0,5,2
01-06-2020 06:00:00,0,0,0,26,8,18,14,14,0,10,16
01-06-2020 07:00:00,3,2,1,50,13,37,13,11,2,10,20
01-06-2020 08:00:00,3,2,1,88,25,63,21,19,2,21,42
01-06-2020 09:00:00,8,8,0,112,38,74,22,14,8,40,23
01-06-2020 10:00:00,9,8,1,133,46,87,35,23,12,108,42
01-06-2020 11:00:00,14,12,2,175,56,119,75,45,30,94,70
01-06-2020 12:00:00,20,16,4,219,77,142,98,60,38,141,77
01-06-2020 13:00:00,16,6,10,259,110,149,114,71,43,170,99
01-06-2020 14:00:00,24,15,9,278,101,177,121,75,46,142,134
01-06-2020 15:00:00,16,13,3,249,101,148,105,60,45,119,104
01-06-2020 16:00:00,21,14,7,266,122,144,80,40,40,127,95
01-06-2020 17:00:00,22,5,17,287,137,150,113,61,52,157,154
01-06-2020 18:00:00,4,3,1,257,164,93,92,55,37,109,106
01-06-2020 19:00:00,5,2,3,227,130,97,64,31,33,91,149
01-06-2020 20:00:00,7,2,5,169,94,75,66,37,29,65,119
01-06-2020 21:00:00,7,1,6,115,60,55,57,23,34,48,52
01-06-2020 22:00:00,5,2,3,55,32,23,30,11,19,36,34
01-06-2020 23:00:00,2,1,1,23,19,4,15,2,13,20,17
02-06-2020 00:00:00,2,1,1,9,4,5,7,5,2,6,7
02-06-2020 01:00:00,0,0,0,7,6,1,2,0,2,2,3
02-06-2020 02:00:00,0,0,0,2,0,2,1,0,1,7,1
02-06-2020 03:00:00,0,0,0,5,3,2,3,1,2,2,1
02-06-2020 04:00:00,1,0,1,13,4,9,1,0,1,5,5
02-06-2020 05:00:00,1,0,1,18,2,16,7,5,2,6,12
02-06-2020 06:00:00,2,2,0,78,10,68,54,51,3,9,67
02-06-2020 07:00:00,2,2,0,170,55,115,74,58,16,32,104
02-06-2020 08:00:00,9,6,3,195,64,131,66,63,3,26,113
02-06-2020 09:00:00,8,6,2,145,38,107,37,28,9,45,64
02-06-2020 10:00:00,9,8,1,100,30,70,44,32,12,55,57
02-06-2020 11:00:00,10,6,4,141,43,98,47,23,24,98,55
02-06-2020 12:00:00,14,8,6,158,60,98,79,48,31,108,46
02-06-2020 13:00:00,11,10,1,197,76,121,75,48,27,147,74
02-06-2020 14:00:00,16,10,6,183,74,109,54,32,22,142,90
02-06-2020 15:00:00,18,11,7,145,49,96,76,32,44,139,78
02-06-2020 16:00:00,11,6,5,235,129,106,80,43,37,151,64
02-06-2020 17:00:00,20,9,11,262,138,124,119,65,54,160,126
02-06-2020 18:00:00,19,7,12,298,161,137,102,55,47,143,114
02-06-2020 19:00:00,12,5,7,195,105,90,52,29,23,73,99
02-06-2020 20:00:00,14,9,5,192,105,87,66,35,31,68,77
02-06-2020 21:00:00,14,6,8,117,72,45,49,16,33,46,111
02-06-2020 22:00:00,7,0,7,55,39,16,31,19,12,25,54
02-06-2020 23:00:00,2,1,1,20,13,7,7,4,3,20,9
03-06-2020 00:00:00,0,0,0,4,4,0,4,3,1,4,2
03-06-2020 01:00:00,1,0,1,6,5,1,0,0,0,2,2
03-06-2020 02:00:00,0,0,0,2,0,2,1,1,0,2,3
03-06-2020 03:00:00,0,0,0,3,3,0,0,0,0,0,1
03-06-2020 04:00:00,1,0,1,13,4,9,3,3,0,3,5
03-06-2020 05:00:00,0,0,0,12,3,9,4,3,1,4,9
03-06-2020 06:00:00,2,2,0,90,18,72,62,58,4,11,71
03-06-2020 07:00:00,5,3,2,168,51,117,63,50,13,30,99
03-06-2020 08:00:00,8,7,1,170,58,112,76,68,8,23,104
03-06-2020 09:00:00,4,1,3,50,5,45,32,29,3,18,61
03-06-2020 10:00:00,4,3,1,37,3,34,13,9,4,19,26
03-06-2020 11:00:00,4,4,0,37,4,33,21,13,8,26,32
03-06-2020 12:00:00,6,4,2,40,6,34,21,12,9,31,20
03-06-2020 13:00:00,6,4,2,77,16,61,55,35,20,45,31
03-06-2020 14:00:00,9,5,4,115,43,72,34,19,15,57,34
03-06-2020 15:00:00,8,5,3,94,48,46,41,20,21,98,37
03-06-2020 16:00:00,12,5,7,174,96,78,75,40,35,106,38
03-06-2020 17:00:00,13,6,7,252,140,112,67,29,38,150,58
03-06-2020 18:00:00,6,4,2,209,111,98,76,58,18,114,47
03-06-2020 19:00:00,7,6,1,163,84,79,72,44,28,71,28
03-06-2020 20:00:00,5,4,1,103,44,59,40,26,14,44,36
03-06-2020 21:00:00,4,1,3,89,52,37,33,20,13,49,29
03-06-2020 22:00:00,3,0,3,33,19,14,16,8,8,30,12
03-06-2020 23:00:00,4,4,0,14,8,6,6,5,1,21,7
04-06-2020 00:00:00,1,0,1,2,0,2,4,2,2,1,6
04-06-2020 01:00:00,0,0,0,5,2,3,1,1,0,1,1
04-06-2020 02:00:00,1,0,1,1,1,0,0,0,0,0,0
04-06-2020 03:00:00,0,0,0,5,1,4,0,0,0,0,1
04-06-2020 04:00:00,1,0,1,12,4,8,2,2,0,4,2
04-06-2020 05:00:00,1,1,0,13,1,12,3,3,0,5,10
04-06-2020 06:00:00,4,4,0,90,12,78,67,63,4,13,69
04-06-2020 07:00:00,4,3,1,163,50,113,63,51,12,26,96
04-06-2020 08:00:00,5,5,0,163,52,111,73,71,2,30,112
04-06-2020 09:00:00,8,7,1,105,12,93,38,31,7,18,53
04-06-2020 10:00:00,4,4,0,68,6,62,24,17,7,19,48
04-06-2020 11:00:00,11,7,4,63,5,58,29,18,11,32,56
04-06-2020 12:00:00,9,5,4,64,9,55,34,26,8,56,43
04-06-2020 13:00:00,6,3,3,85,18,67,41,22,19,64,39
04-06-2020 14:00:00,12,9,3,105,54,51,28,18,10,57,31
04-06-2020 15:00:00,7,6,1,117,58,59,49,28,21,57,41
04-06-2020 16:00:00,12,5,7,174,97,77,61,34,27,106,39
04-06-2020 17:00:00,15,6,9,279,143,136,67,29,38,133,31
04-06-2020 18:00:00,6,3,3,197,103,94,75,43,32,125,36
04-06-2020 19:00:00,12,8,4,185,97,88,55,37,18,98,62
04-06-2020 20:00:00,6,4,2,139,71,68,43,19,24,61,66
04-06-2020 21:00:00,13,8,5,82,48,34,35,18,17,48,25
04-06-2020 22:00:00,3,1,2,63,31,32,34,11,23,30,21
04-06-2020 23:00:00,6,3,3,27,17,10,8,4,4,14,14
05-06-2020 00:00:00,0,0,0,9,5,4,0,0,0,7,1
05-06-2020 01:00:00,0,0,0,3,2,1,2,1,1,0,1
05-06-2020 02:00:00,0,0,0,7,2,5,1,1,0,3,3
05-06-2020 03:00:00,0,0,0,3,1,2,1,1,0,3,2
05-06-2020 04:00:00,1,1,0,13,3,10,1,1,0,2,3
05-06-2020 05:00:00,0,0,0,15,2,13,2,2,0,3,6
05-06-2020 06:00:00,3,3,0,64,9,55,53,49,4,7,74
05-06-2020 07:00:00,4,2,2,134,36,98,67,53,14,29,77
05-06-2020 08:00:00,4,3,1,168,55,113,65,61,4,19,92
05-06-2020 09:00:00,6,3,3,110,31,79,43,38,5,29,44
05-06-2020 10:00:00,9,4,5,79,25,54,38,33,5,43,36
05-06-2020 11:00:00,6,5,1,84,32,52,22,13,9,28,38
05-06-2020 12:00:00,8,6,2,126,49,77,34,21,13,52,48
05-06-2020 13:00:00,9,7,2,118,56,62,40,27,13,75,54
05-06-2020 14:00:00,12,7,5,107,51,56,45,19,26,81,62
05-06-2020 15:00:00,6,2,4,123,65,58,54,31,23,72,48
05-06-2020 16:00:00,7,5,2,165,78,87,51,27,24,105,29
05-06-2020 17:00:00,15,5,10,211,116,95,75,42,33,119,59
05-06-2020 18:00:00,8,7,1,184,95,89,51,33,18,123,43
05-06-2020 19:00:00,17,8,9,151,76,75,64,37,27,58,55
05-06-2020 20:00:00,14,8,6,103,54,49,36,26,10,54,46
05-06-2020 21:00:00,8,4,4,101,46,55,37,25,12,48,46
05-06-2020 22:00:00,1,0,1,61,32,29,28,18,10,34,6
05-06-2020 23:00:00,2,2,0,27,15,12,15,5,10,17,12
06-06-2020 00:00:00,0,0,0,19,11,8,7,6,1,7,5
06-06-2020 01:00:00,1,0,1,15,10,5,3,1,2,3,4
06-06-2020 02:00:00,0,0,0,5,1,4,0,0,0,3,0
06-06-2020 03:00:00,1,1,0,6,4,2,1,1,0,1,0
06-06-2020 04:00:00,0,0,0,7,3,4,2,2,0,4,1
06-06-2020 05:00:00,0,0,0,8,4,4,4,3,1,6,4
06-06-2020 06:00:00,0,0,0,15,4,11,9,8,1,10,10
06-06-2020 07:00:00,0,0,0,46,13,33,29,22,7,4,28
06-06-2020 08:00:00,7,5,2,35,11,24,17,15,2,13,20
06-06-2020 09:00:00,5,2,3,59,20,39,14,14,0,16,25
06-06-2020 10:00:00,5,2,3,62,20,42,25,18,7,18,28
06-06-2020 11:00:00,2,0,2,90,41,49,23,14,9,28,34
06-06-2020 12:00:00,9,4,5,103,46,57,31,24,7,45,41
06-06-2020 13:00:00,7,5,2,108,46,62,33,22,11,56,29
06-06-2020 14:00:00,2,1,1,163,47,116,72,57,15,52,50
06-06-2020 15:00:00,9,7,2,146,58,88,71,52,19,64,59
06-06-2020 16:00:00,8,5,3,146,83,63,43,22,21,60,63
06-06-2020 17:00:00,4,3,1,129,81,48,32,13,19,82,36
06-06-2020 18:00:00,3,2,1,118,60,58,37,18,19,57,35
06-06-2020 19:00:00,9,7,2,103,52,51,32,22,10,44,33
06-06-2020 20:00:00,3,1,2,96,52,44,30,16,14,43,28
06-06-2020 21:00:00,5,2,3,64,35,29,17,11,6,29,20
06-06-2020 22:00:00,1,1,0,60,36,24,18,10,8,19,14
06-06-2020 23:00:00,0,0,0,19,14,5,12,8,4,12,10
07-06-2020 00:00:00,1,1,0,17,8,9,4,4,0,7,2
07-06-2020 01:00:00,3,1,2,11,6,5,2,0,2,4,3
07-06-2020 02:00:00,2,2,0,5,4,1,3,0,3,6,5
07-06-2020 03:00:00,0,0,0,5,1,4,0,0,0,3,4
07-06-2020 04:00:00,0,0,0,6,1,5,0,0,0,2,3
07-06-2020 05:00:00,0,0,0,11,4,7,3,2,1,0,1
07-06-2020 06:00:00,0,0,0,14,5,9,3,2,1,8,8
07-06-2020 07:00:00,0,0,0,31,10,21,11,9,2,7,13
07-06-2020 08:00:00,4,4,0,32,16,16,21,17,4,23,19
07-06-2020 09:00:00,6,5,1,61,24,37,14,11,3,36,13
07-06-2020 10:00:00,6,2,4,100,30,70,31,18,13,35,31
07-06-2020 11:00:00,4,2,2,120,46,74,34,25,9,47,50
07-06-2020 12:00:00,12,6,6,159,71,88,71,39,32,89,60
07-06-2020 13:00:00,9,8,1,167,55,112,81,47,34,90,79
07-06-2020 14:00:00,10,6,4,226,88,138,64,44,20,91,72
07-06-2020 15:00:00,13,7,6,178,95,83,87,62,25,93,94
07-06-2020 16:00:00,8,3,5,213,105,108,57,28,29,118,78
07-06-2020 17:00:00,8,5,3,176,78,98,79,38,41,88,80
07-06-2020 18:00:00,6,0,6,190,79,111,83,43,40,75,69
07-06-2020 19:00:00,10,4,6,158,85,73,59,41,18,90,91
07-06-2020 20:00:00,3,2,1,166,74,92,60,29,31,52,69
07-06-2020 21:00:00,7,2,5,101,66,35,50,27,23,47,41
07-06-2020 22:00:00,5,5,0,72,43,29,27,16,11,36,23
07-06-2020 23:00:00,4,3,1,24,18,6,12,3,9,23,4
08-06-2020 00:00:00,0,0,0,7,4,3,4,4,0,6,7
08-06-2020 01:00:00,1,1,0,3,3,0,3,3,0,2,0
08-06-2020 02:00:00,0,0,0,5,2,3,4,2,2,2,2
08-06-2020 03:00:00,0,0,0,6,5,1,1,1,0,1,0
08-06-2020 04:00:00,1,0,1,7,3,4,4,4,0,8,3
08-06-2020 05:00:00,0,0,0,17,5,12,5,5,0,5,13
08-06-2020 06:00:00,2,2,0,92,20,72,72,65,7,15,75
08-06-2020 07:00:00,14,12,2,171,49,122,84,75,9,32,114
08-06-2020 08:00:00,6,5,1,196,57,139,74,70,4,33,133
08-06-2020 09:00:00,4,2,2,103,28,75,52,44,8,28,56
08-06-2020 10:00:00,5,3,2,76,24,52,28,21,7,39,55
08-06-2020 11:00:00,7,4,3,96,37,59,51,35,16,46,57
08-06-2020 12:00:00,5,3,2,135,52,83,41,32,9,61,60
08-06-2020 13:00:00,10,6,4,158,54,104,57,41,16,68,59
08-06-2020 14:00:00,14,12,2,156,67,89,55,31,24,110,57
08-06-2020 15:00:00,13,7,6,194,98,96,61,34,27,97,70
08-06-2020 16:00:00,18,9,9,198,109,89,83,36,47,162,69
08-06-2020 17:00:00,10,6,4,300,158,142,104,56,48,189,49
08-06-2020 18:00:00,16,12,4,270,139,131,99,49,50,177,83
08-06-2020 19:00:00,9,6,3,224,106,118,88,60,28,81,94
08-06-2020 20:00:00,1,0,1,157,79,78,57,32,25,79,57
08-06-2020 21:00:00,7,4,3,130,71,59,47,22,25,56,62
08-06-2020 22:00:00,2,2,0,59,37,22,40,20,20,24,16
08-06-2020 23:00:00,1,0,1,24,14,10,13,5,8,23,11
09-06-2020 00:00:00,0,0,0,10,5,5,0,0,0,9,7
09-06-2020 01:00:00,0,0,0,10,5,5,2,2,0,6,3
09-06-2020 02:00:00,0,0,0,2,1,1,0,0,0,2,2
09-06-2020 03:00:00,0,0,0,5,3,2,2,2,0,2,0
09-06-2020 04:00:00,0,0,0,8,3,5,3,3,0,2,5
09-06-2020 05:00:00,0,0,0,15,2,13,5,5,0,6,9
09-06-2020 06:00:00,4,4,0,93,12,81,69,64,5,16,67
09-06-2020 07:00:00,8,5,3,188,56,132,92,77,15,27,106
09-06-2020 08:00:00,6,6,0,200,56,144,80,73,7,36,144
09-06-2020 09:00:00,7,7,0,128,35,93,44,39,5,22,75
09-06-2020 10:00:00,10,6,4,52,8,44,29,22,7,27,39
09-06-2020 11:00:00,6,2,4,91,39,52,29,14,15,42,33
09-06-2020 12:00:00,3,1,2,127,53,74,31,25,6,53,54
09-06-2020 13:00:00,10,7,3,165,71,94,64,40,24,62,62
09-06-2020 14:00:00,5,2,3,137,71,66,59,36,23,77,49
09-06-2020 15:00:00,11,5,6,135,64,71,39,19,20,88,38
09-06-2020 16:00:00,5,4,1,184,101,83,66,30,36,111,52
09-06-2020 17:00:00,11,5,6,252,141,111,68,35,33,144,77
09-06-2020 18:00:00,8,5,3,214,134,80,70,39,31,163,38
09-06-2020 19:00:00,5,2,3,136,70,66,53,27,26,83,49
09-06-2020 20:00:00,3,2,1,108,54,54,40,22,18,55,57
09-06-2020 21:00:00,4,3,1,95,43,52,42,20,22,39,28
09-06-2020 22:00:00,3,3,0,51,33,18,31,12,19,23,29
09-06-2020 23:00:00,1,0,1,21,13,8,1,1,0,11,11
10-06-2020 00:00:00,1,0,1,8,3,5,2,2,0,5,8
10-06-2020 01:00:00,0,0,0,4,3,1,0,0,0,2,3
10-06-2020 02:00:00,0,0,0,2,0,2,0,0,0,6,3
10-06-2020 03:00:00,0,0,0,5,3,2,1,1,0,0,0
10-06-2020 04:00:00,0,0,0,10,3,7,1,1,0,1,1
10-06-2020 05:00:00,0,0,0,14,4,10,10,9,1,3,14
10-06-2020 06:00:00,1,1,0,75,12,63,67,59,8,11,63
10-06-2020 07:00:00,11,9,2,184,57,127,69,59,10,29,116
10-06-2020 08:00:00,8,8,0,191,60,131,65,58,7,25,115
10-06-2020 09:00:00,5,4,1,85,25,60,49,39,10,14,50
10-06-2020 10:00:00,5,4,1,48,18,30,28,23,5,24,22
10-06-2020 11:00:00,3,2,1,73,26,47,19,15,4,25,32
10-06-2020 12:00:00,6,3,3,90,40,50,23,17,6,41,33
10-06-2020 13:00:00,4,3,1,101,42,59,35,23,12,63,54
10-06-2020 14:00:00,7,4,3,111,51,60,44,25,19,56,50
10-06-2020 15:00:00,14,6,8,134,67,67,48,32,16,84,35
10-06-2020 16:00:00,12,7,5,165,98,67,59,31,28,136,35
10-06-2020 17:00:00,14,7,7,268,138,130,54,24,30,155,62
10-06-2020 18:00:00,6,1,5,207,122,85,60,30,30,123,42
10-06-2020 19:00:00,2,1,1,117,59,58,47,28,19,72,41
10-06-2020 20:00:00,13,3,10,78,41,37,45,20,25,46,31
10-06-2020 21:00:00,6,4,2,58,35,23,16,6,10,40,20
10-06-2020 22:00:00,2,0,2,39,26,13,16,8,8,23,15
10-06-2020 23:00:00,1,1,0,23,11,12,12,6,6,8,3
11-06-2020 00:00:00,1,0,1,7,4,3,2,2,0,2,1
11-06-2020 01:00:00,0,0,0,4,1,3,0,0,0,0,2
11-06-2020 02:00:00,1,0,1,0,0,0,1,1,0,1,1
11-06-2020 03:00:00,0,0,0,3,1,2,2,2,0,1,0
11-06-2020 04:00:00,0,0,0,9,2,7,4,4,0,1,3
11-06-2020 05:00:00,0,0,0,11,3,8,7,6,1,6,7
11-06-2020 06:00:00,4,4,0,59,8,51,58,55,3,14,69
11-06-2020 07:00:00,7,4,3,155,44,111,78,60,18,21,93
11-06-2020 08:00:00,6,4,2,145,52,93,77,71,6,22,88
11-06-2020 09:00:00,5,4,1,90,26,64,30,24,6,16,47
11-06-2020 10:00:00,7,6,1,82,29,53,20,19,1,29,32
11-06-2020 11:00:00,6,1,5,69,27,42,31,24,7,31,20
11-06-2020 12:00:00,14,5,9,108,41,67,27,15,12,39,34
11-06-2020 13:00:00,4,3,1,122,50,72,43,25,18,59,29
11-06-2020 14:00:00,9,6,3,126,50,76,31,18,13,56,38
11-06-2020 15:00:00,7,5,2,81,40,41,30,14,16,38,23
11-06-2020 16:00:00,2,1,1,86,54,32,25,14,11,73,37
11-06-2020 17:00:00,6,3,3,185,89,96,46,20,26,123,40
11-06-2020 18:00:00,6,4,2,188,105,83,63,41,22,124,42
11-06-2020 19:00:00,7,4,3,114,57,57,53,34,19,65,41
11-06-2020 20:00:00,5,2,3,84,48,36,36,22,14,45,22
11-06-2020 21:00:00,6,3,3,75,47,28,18,7,11,33,18
11-06-2020 22:00:00,6,5,1,32,22,10,14,6,8,32,17
11-06-2020 23:00:00,3,1,2,25,12,13,9,6,3,18,7
12-06-2020 00:00:00,1,0,1,10,6,4,4,4,0,6,2
12-06-2020 01:00:00,0,0,0,3,2,1,1,1,0,0,4
12-06-2020 02:00:00,1,1,0,1,1,0,0,0,0,0,0
12-06-2020 03:00:00,0,0,0,6,2,4,1,1,0,0,1
12-06-2020 04:00:00,1,0,1,8,4,4,2,2,0,2,2
12-06-2020 05:00:00,0,0,0,15,5,10,7,7,0,3,9
12-06-2020 06:00:00,5,1,4,56,9,47,49,43,6,11,62
12-06-2020 07:00:00,9,6,3,127,40,87,51,42,9,20,67
12-06-2020 08:00:00,5,4,1,137,46,91,65,60,5,14,81
12-06-2020 09:00:00,4,3,1,81,21,60,35,27,8,21,45
12-06-2020 10:00:00,4,1,3,72,17,55,31,21,10,16,34
12-06-2020 11:00:00,1,0,1,102,32,70,41,30,11,30,36
12-06-2020 12:00:00,6,3,3,101,34,67,42,28,14,49,42
12-06-2020 13:00:00,9,4,5,130,56,74,44,27,17,57,45
12-06-2020 14:00:00,6,3,3,112,49,63,32,21,11,57,52
12-06-2020 15:00:00,11,10,1,135,62,73,57,29,28,65,41
12-06-2020 16:00:00,15,8,7,157,70,87,67,31,36,110,40
12-06-2020 17:00:00,8,3,5,204,101,103,63,35,28,126,48
12-06-2020 18:00:00,11,7,4,180,86,94,51,31,20,110,60
12-06-2020 19:00:00,10,5,5,142,83,59,48,26,22,58,55
12-06-2020 20:00:00,8,3,5,108,51,57,43,24,19,30,35
12-06-2020 21:00:00,3,1,2,63,33,30,23,12,11,36,20
12-06-2020 22:00:00,5,2,3,67,46,21,25,16,9,24,13
12-06-2020 23:00:00,1,0,1,36,22,14,9,7,2,20,16
13-06-2020 00:00:00,2,1,1,22,15,7,7,5,2,8,7
13-06-2020 01:00:00,0,0,0,15,7,8,2,0,2,5,5
13-06-2020 02:00:00,0,0,0,13,6,7,1,1,0,2,6
13-06-2020 03:00:00,0,0,0,8,5,3,1,1,0,5,0
13-06-2020 04:00:00,0,0,0,9,6,3,0,0,0,2,1
13-06-2020 05:00:00,0,0,0,8,2,6,3,2,1,5,5
13-06-2020 06:00:00,2,1,1,16,2,14,10,10,0,9,6
13-06-2020 07:00:00,1,1,0,40,17,23,19,18,1,5,30
13-06-2020 08:00:00,3,3,0,51,15,36,22,19,3,10,24
13-06-2020 09:00:00,1,0,1,58,21,37,24,17,7,16,28
13-06-2020 10:00:00,7,2,5,64,22,42,36,18,18,43,36
13-06-2020 11:00:00,4,1,3,111,36,75,28,25,3,49,38
13-06-2020 12:00:00,6,5,1,132,53,79,48,31,17,62,70
13-06-2020 13:00:00,8,5,3,175,67,108,52,29,23,88,70
13-06-2020 14:00:00,8,5,3,157,62,95,69,40,29,68,66
13-06-2020 15:00:00,8,6,2,148,54,94,56,39,17,109,94
13-06-2020 16:00:00,7,3,4,173,75,98,63,31,32,119,89
13-06-2020 17:00:00,7,6,1,177,86,91,81,51,30,79,69
13-06-2020 18:00:00,10,8,2,192,98,94,68,41,27,107,82
13-06-2020 19:00:00,8,6,2,170,82,88,74,51,23,64,68
13-06-2020 20:00:00,7,2,5,147,72,75,52,33,19,46,68
13-06-2020 21:00:00,9,6,3,119,68,51,51,28,23,61,47
13-06-2020 22:00:00,6,1,5,67,44,23,32,14,18,38,34
13-06-2020 23:00:00,1,0,1,49,26,23,34,17,17,27,19
14-06-2020 00:00:00,0,0,0,35,20,15,8,5,3,19,9
14-06-2020 01:00:00,1,1,0,24,15,9,4,0,4,8,2
14-06-2020 02:00:00,0,0,0,23,12,11,5,4,1,3,2
14-06-2020 03:00:00,2,0,2,9,5,4,1,0,1,5,3
14-06-2020 04:00:00,0,0,0,5,3,2,2,0,2,11,2
14-06-2020 05:00:00,0,0,0,7,2,5,4,2,2,1,3
14-06-2020 06:00:00,2,1,1,15,5,10,9,8,1,4,8
14-06-2020 07:00:00,6,4,2,47,15,32,10,10,0,14,23
14-06-2020 08:00:00,5,4,1,51,17,34,34,30,4,26,40
14-06-2020 09:00:00,7,5,2,53,23,30,33,19,14,19,35
14-06-2020 10:00:00,6,5,1,104,34,70,47,29,18,60,48
14-06-2020 11:00:00,9,7,2,134,52,82,47,33,14,61,63
14-06-2020 12:00:00,11,6,5,196,81,115,79,48,31,102,99
14-06-2020 13:00:00,21,13,8,234,73,161,85,57,28,151,98
14-06-2020 14:00:00,10,4,6,225,101,124,74,53,21,127,93
14-06-2020 15:00:00,9,6,3,137,86,51,67,34,33,71,97
14-06-2020 16:00:00,5,4,1,145,63,82,73,38,35,81,95
14-06-2020 17:00:00,13,9,4,115,57,58,75,42,33,91,73
14-06-2020 18:00:00,11,10,1,174,97,77,48,31,17,81,85
14-06-2020 19:00:00,5,0,5,141,75,66,64,47,17,64,59
14-06-2020 20:00:00,3,0,3,141,64,77,51,30,21,68,58
14-06-2020 21:00:00,6,4,2,94,53,41,51,29,22,43,70
14-06-2020 22:00:00,4,1,3,63,43,20,22,17,5,40,30
14-06-2020 23:00:00,6,2,4,22,18,4,20,9,11,19,13
15-06-2020 00:00:00,0,0,0,5,3,2,3,1,2,8,3
15-06-2020 01:00:00,0,0,0,5,2,3,1,1,0,4,1
15-06-2020 02:00:00,0,0,0,2,2,0,4,2,2,0,1
15-06-2020 03:00:00,0,0,0,4,2,2,3,3,0,2,0
15-06-2020 04:00:00,0,0,0,8,4,4,1,1,0,1,3
15-06-2020 05:00:00,0,0,0,17,9,8,5,5,0,4,12
15-06-2020 06:00:00,4,4,0,97,15,82,59,54,5,10,69
15-06-2020 07:00:00,11,9,2,180,61,119,87,75,12,36,111
15-06-2020 08:00:00,5,5,0,208,74,134,75,69,6,37,143
15-06-2020 09:00:00,9,8,1,121,27,94,62,49,13,33,84
15-06-2020 10:00:00,11,4,7,85,27,58,41,30,11,35,56
15-06-2020 11:00:00,10,3,7,110,32,78,56,33,23,35,44
15-06-2020 12:00:00,12,7,5,142,65,77,55,33,22,57,64
15-06-2020 13:00:00,13,12,1,146,59,87,52,22,30,111,59
15-06-2020 14:00:00,12,6,6,136,57,79,57,37,20,104,71
15-06-2020 15:00:00,12,4,8,157,74,83,89,51,38,135,82
15-06-2020 16:00:00,18,12,6,217,105,112,80,46,34,186,95
15-06-2020 17:00:00,8,4,4,310,157,153,107,59,48,231,97
15-06-2020 18:00:00,11,9,2,285,146,139,108,58,50,181,67
15-06-2020 19:00:00,12,8,4,250,123,127,90,45,45,103,99
15-06-2020 20:00:00,13,5,8,182,110,72,81,33,48,57,101
15-06-2020 21:00:00,16,4,12,141,87,54,65,37,28,60,67
15-06-2020 22:00:00,4,1,3,75,51,24,44,19,25,36,42
15-06-2020 23:00:00,2,0,2,34,23,11,8,5,3,23,25
16-06-2020 00:00:00,0,0,0,14,9,5,3,1,2,7,9
16-06-2020 01:00:00,0,0,0,1,1,0,2,0,2,3,3
16-06-2020 02:00:00,0,0,0,4,2,2,0,0,0,2,1
16-06-2020 03:00:00,1,1,0,7,5,2,1,1,0,3,0
16-06-2020 04:00:00,0,0,0,7,3,4,1,1,0,4,3
16-06-2020 05:00:00,1,1,0,21,2,19,5,5,0,7,11
16-06-2020 06:00:00,4,4,0,106,17,89,69,63,6,14,77
16-06-2020 07:00:00,8,7,1,202,50,152,86,73,13,32,111
16-06-2020 08:00:00,10,9,1,216,66,150,86,71,15,35,143
16-06-2020 09:00:00,6,4,2,121,33,88,41,37,4,22,83
16-06-2020 10:00:00,4,3,1,73,20,53,22,15,7,17,52
16-06-2020 11:00:00,7,5,2,92,33,59,24,17,7,39,39
16-06-2020 12:00:00,9,2,7,114,42,72,44,30,14,37,59
16-06-2020 13:00:00,19,14,5,143,69,74,49,29,20,57,66
16-06-2020 14:00:00,13,6,7,119,57,62,49,22,27,66,61
16-06-2020 15:00:00,14,8,6,136,73,63,54,26,28,108,50
16-06-2020 16:00:00,15,9,6,215,108,107,67,35,32,120,44
16-06-2020 17:00:00,5,5,0,297,162,135,98,55,43,172,69
16-06-2020 18:00:00,22,14,8,265,138,127,94,56,38,167,54
16-06-2020 19:00:00,10,6,4,202,107,95,67,42,25,113,75
16-06-2020 20:00:00,10,3,7,134,72,62,40,22,18,70,57
16-06-2020 21:00:00,4,2,2,96,57,39,49,28,21,51,52
16-06-2020 22:00:00,0,0,0,66,41,25,23,15,8,25,23
16-06-2020 23:00:00,1,1,0,26,13,13,12,4,8,16,6
17-06-2020 00:00:00,0,0,0,13,9,4,5,4,1,6,7
17-06-2020 01:00:00,0,0,0,7,4,3,4,0,4,8,2
17-06-2020 02:00:00,0,0,0,2,2,0,0,0,0,6,1
17-06-2020 03:00:00,0,0,0,4,2,2,1,1,0,2,0
17-06-2020 04:00:00,0,0,0,10,3,7,1,1,0,1,2
17-06-2020 05:00:00,0,0,0,14,3,11,1,1,0,1,5
17-06-2020 06:00:00,4,4,0,48,6,42,36,32,4,6,39
17-06-2020 07:00:00,8,7,1,87,23,64,55,45,10,12,74
17-06-2020 08:00:00,3,3,0,165,55,110,67,64,3,15,108
17-06-2020 09:00:00,6,5,1,102,21,81,32,29,3,23,70
17-06-2020 10:00:00,3,2,1,76,22,54,32,25,7,22,45
17-06-2020 11:00:00,12,8,4,95,36,59,30,24,6,45,50
17-06-2020 12:00:00,7,3,4,115,45,70,39,27,12,42,49
17-06-2020 13:00:00,11,8,3,112,38,74,39,25,14,65,40
17-06-2020 14:00:00,3,3,0,119,46,73,38,23,15,48,64
17-06-2020 15:00:00,9,5,4,112,49,63,42,20,22,76,53
17-06-2020 16:00:00,4,2,2,135,69,66,64,36,28,103,68
17-06-2020 17:00:00,16,10,6,217,122,95,59,30,29,145,61
17-06-2020 18:00:00,13,9,4,202,110,92,93,59,34,144,62
17-06-2020 19:00:00,15,10,5,191,91,100,59,33,26,85,51
17-06-2020 20:00:00,3,2,1,130,63,67,52,28,24,52,63
17-06-2020 21:00:00,12,9,3,83,48,35,32,16,16,46,39
17-06-2020 22:00:00,6,1,5,63,43,20,30,13,17,35,18
17-06-2020 23:00:00,2,1,1,28,16,12,14,6,8,16,18
18-06-2020 00:00:00,4,4,0,21,11,10,3,2,1,11,8
18-06-2020 01:00:00,1,0,1,6,3,3,0,0,0,1,1
18-06-2020 02:00:00,1,0,1,4,1,3,2,2,0,3,3
18-06-2020 03:00:00,0,0,0,5,3,2,0,0,0,0,0
18-06-2020 04:00:00,0,0,0,5,2,3,4,4,0,2,3
18-06-2020 05:00:00,0,0,0,16,4,12,5,4,1,3,11
18-06-2020 06:00:00,7,7,0,85,10,75,75,67,8,29,64
18-06-2020 07:00:00,13,9,4,190,58,132,75,64,11,27,120
18-06-2020 08:00:00,4,4,0,199,59,140,99,90,9,35,146
18-06-2020 09:00:00,8,7,1,127,33,94,45,35,10,26,80
18-06-2020 10:00:00,2,2,0,78,28,50,39,30,9,26,54
18-06-2020 11:00:00,3,2,1,93,24,69,44,30,14,39,50
18-06-2020 12:00:00,10,4,6,139,46,93,42,28,14,56,53
18-06-2020 13:00:00,7,1,6,146,66,80,58,29,29,69,64
18-06-2020 14:00:00,7,5,2,126,59,67,37,25,12,59,63
18-06-2020 15:00:00,13,7,6,120,58,62,38,20,18,78,45
18-06-2020 16:00:00,7,5,2,162,90,72,76,41,35,109,45
18-06-2020 17:00:00,3,2,1,217,127,90,73,45,28,152,45
18-06-2020 18:00:00,7,1,6,195,108,87,71,36,35,152,44
18-06-2020 19:00:00,5,4,1,151,75,76,50,31,19,64,47
18-06-2020 20:00:00,6,4,2,121,70,51,40,27,13,59,60
18-06-2020 21:00:00,4,1,3,60,36,24,28,18,10,46,15
18-06-2020 22:00:00,2,2,0,52,37,15,15,5,10,20,12
18-06-2020 23:00:00,0,0,0,17,9,8,3,2,1,7,6
19-06-2020 00:00:00,0,0,0,11,6,5,3,0,3,8,0
19-06-2020 01:00:00,1,0,1,0,0,0,0,0,0,0,1
19-06-2020 02:00:00,1,0,1,4,3,1,1,0,1,0,1
19-06-2020 03:00:00,0,0,0,3,1,2,1,1,0,0,1
19-06-2020 04:00:00,0,0,0,9,4,5,0,0,0,3,1
19-06-2020 05:00:00,0,0,0,16,3,13,7,6,1,4,10
19-06-2020 06:00:00,4,3,1,59,9,50,60,56,4,13,48
19-06-2020 07:00:00,8,8,0,138,36,102,53,44,9,19,67
19-06-2020 08:00:00,5,4,1,161,44,117,66,64,2,17,93
19-06-2020 09:00:00,5,1,4,102,30,72,33,25,8,24,48
19-06-2020 10:00:00,2,2,0,77,23,54,18,16,2,20,35
19-06-2020 11:00:00,6,3,3,88,31,57,22,12,10,29,33
19-06-2020 12:00:00,4,4,0,108,43,65,38,22,16,45,49
19-06-2020 13:00:00,6,3,3,139,60,79,42,23,19,67,58
19-06-2020 14:00:00,10,7,3,125,61,64,44,23,21,45,55
19-06-2020 15:00:00,3,1,2,105,46,59,48,25,23,79,30
19-06-2020 16:00:00,7,5,2,153,81,72,62,31,31,91,45
19-06-2020 17:00:00,9,5,4,223,123,100,92,56,36,97,48
19-06-2020 18:00:00,10,5,5,208,106,102,71,43,28,129,60
19-06-2020 19:00:00,16,11,5,211,107,104,67,41,26,68,64
19-06-2020 20:00:00,10,5,5,143,72,71,65,39,26,87,63
19-06-2020 21:00:00,3,2,1,104,62,42,28,15,13,57,49
19-06-2020 22:00:00,12,7,5,66,39,27,35,19,16,26,24
19-06-2020 23:00:00,4,0,4,46,28,18,31,15,16,41,23
20-06-2020 00:00:00,1,0,1,27,14,13,14,12,2,15,4
20-06-2020 01:00:00,3,3,0,22,11,11,2,1,1,13,5
20-06-2020 02:00:00,0,0,0,12,7,5,3,0,3,6,8
20-06-2020 03:00:00,1,1,0,10,7,3,5,2,3,13,1
20-06-2020 04:00:00,0,0,0,17,4,13,1,1,0,6,3
20-06-2020 05:00:00,0,0,0,10,3,7,3,2,1,7,2
20-06-2020 06:00:00,1,1,0,25,6,19,16,15,1,11,12
20-06-2020 07:00:00,1,1,0,59,21,38,33,28,5,15,41
20-06-2020 08:00:00,12,12,0,73,22,51,32,28,4,29,47
20-06-2020 09:00:00,6,5,1,121,37,84,37,28,9,31,55
20-06-2020 10:00:00,19,10,9,138,56,82,51,31,20,75,48
20-06-2020 11:00:00,7,6,1,194,54,140,90,45,45,93,86
20-06-2020 12:00:00,17,9,8,172,78,94,75,52,23,132,123
20-06-2020 13:00:00,14,8,6,194,71,123,83,47,36,112,115
20-06-2020 14:00:00,14,9,5,206,100,106,84,51,33,142,115
20-06-2020 15:00:00,9,7,2,189,94,95,83,50,33,124,144
20-06-2020 16:00:00,14,6,8,177,79,98,75,38,37,80,127
20-06-2020 17:00:00,10,2,8,180,97,83,74,46,28,82,99
20-06-2020 18:00:00,3,1,2,176,98,78,51,35,16,80,77
20-06-2020 19:00:00,5,1,4,133,69,64,32,24,8,56,36
20-06-2020 20:00:00,3,2,1,98,60,38,40,26,14,43,40
20-06-2020 21:00:00,4,3,1,78,52,26,23,14,9,34,22
20-06-2020 22:00:00,4,2,2,46,29,17,18,12,6,24,20
20-06-2020 23:00:00,0,0,0,30,16,14,4,4,0,18,9
21-06-2020 00:00:00,2,1,1,26,14,12,7,4,3,13,6
21-06-2020 01:00:00,0,0,0,11,5,6,4,4,0,7,4
21-06-2020 02:00:00,0,0,0,8,5,3,4,2,2,3,1
21-06-2020 03:00:00,0,0,0,9,4,5,0,0,0,5,1
21-06-2020 04:00:00,0,0,0,13,5,8,4,4,0,8,17
21-06-2020 05:00:00,0,0,0,11,2,9,2,1,1,7,6
21-06-2020 06:00:00,1,0,1,21,4,17,11,8,3,6,14
21-06-2020 07:00:00,3,3,0,32,8,24,12,12,0,11,19
21-06-2020 08:00:00,1,0,1,46,11,35,22,15,7,31,18
21-06-2020 09:00:00,6,3,3,66,26,40,25,13,12,21,38
21-06-2020 10:00:00,3,2,1,73,29,44,23,16,7,33,30
21-06-2020 11:00:00,12,8,4,99,40,59,40,29,11,46,53
21-06-2020 12:00:00,6,4,2,114,54,60,53,37,16,65,71
21-06-2020 13:00:00,6,4,2,131,53,78,74,44,30,85,60
21-06-2020 14:00:00,15,10,5,161,71,90,72,37,35,82,82
21-06-2020 15:00:00,9,7,2,148,60,88,67,34,33,86,68
21-06-2020 16:00:00,10,7,3,135,50,85,44,26,18,81,89
21-06-2020 17:00:00,8,4,4,158,64,94,61,41,20,88,87
21-06-2020 18:00:00,8,5,3,151,75,76,61,30,31,59,74
21-06-2020 19:00:00,13,11,2,124,69,55,57,37,20,73,46
21-06-2020 20:00:00,12,6,6,110,61,49,49,25,24,57,63
21-06-2020 21:00:00,16,12,4,111,65,46,44,23,21,46,70
21-06-2020 22:00:00,6,2,4,60,43,17,37,17,20,44,27
21-06-2020 23:00:00,1,1,0,32,20,12,7,6,1,16,7
22-06-2020 00:00:00,0,0,0,12,8,4,9,8,1,15,11
22-06-2020 01:00:00,2,0,2,5,3,2,4,0,4,5,3
22-06-2020 02:00:00,1,1,0,4,3,1,1,1,0,4,0
22-06-2020 03:00:00,1,0,1,8,5,3,1,1,0,1,1
22-06-2020 04:00:00,0,0,0,8,3,5,3,2,1,2,6
22-06-2020 05:00:00,1,1,0,16,6,10,8,8,0,2,10
22-06-2020 06:00:00,4,4,0,61,10,51,58,55,3,7,53
22-06-2020 07:00:00,4,3,1,129,38,91,72,61,11,19,74
22-06-2020 08:00:00,6,5,1,187,71,116,64,63,1,27,104
22-06-2020 09:00:00,0,0,0,102,30,72,47,37,10,28,66
22-06-2020 10:00:00,2,2,0,50,12,38,20,16,4,19,40
22-06-2020 11:00:00,2,1,1,88,33,55,30,23,7,25,48
22-06-2020 12:00:00,8,6,2,110,45,65,49,33,16,40,45
22-06-2020 13:00:00,6,5,1,129,63,66,48,36,12,70,58
22-06-2020 14:00:00,10,6,4,89,35,54,44,27,17,50,46
22-06-2020 15:00:00,10,6,4,133,61,72,35,17,18,74,44
22-06-2020 16:00:00,11,6,5,175,93,82,50,24,26,118,41
22-06-2020 17:00:00,10,6,4,214,124,90,58,39,19,143,54
22-06-2020 18:00:00,16,13,3,196,111,85,69,42,27,150,67
22-06-2020 19:00:00,9,2,7,134,59,75,61,39,22,65,29
22-06-2020 20:00:00,8,5,3,128,63,65,31,15,16,55,41
22-06-2020 21:00:00,4,1,3,82,45,37,38,17,21,39,27
22-06-2020 22:00:00,4,1,3,52,32,20,23,13,10,34,19
22-06-2020 23:00:00,2,1,1,30,20,10,9,6,3,9,5
23-06-2020 00:00:00,0,0,0,13,5,8,7,3,4,7,5
23-06-2020 01:00:00,0,0,0,2,1,1,0,0,0,4,2
23-06-2020 02:00:00,0,0,0,4,1,3,0,0,0,0,3
23-06-2020 03:00:00,2,0,2,7,4,3,1,1,0,0,0
23-06-2020 04:00:00,0,0,0,5,2,3,2,2,0,1,6
23-06-2020 05:00:00,1,1,0,24,8,16,11,8,3,9,11
23-06-2020 06:00:00,6,5,1,70,13,57,67,58,9,14,62
23-06-2020 07:00:00,7,6,1,186,56,130,83,65,18,24,107
23-06-2020 08:00:00,9,9,0,196,64,132,86,78,8,31,150
23-06-2020 09:00:00,6,6,0,129,40,89,52,45,7,20,72
23-06-2020 10:00:00,5,3,2,72,19,53,26,19,7,20,48
23-06-2020 11:00:00,3,0,3,78,33,45,22,17,5,23,27
23-06-2020 12:00:00,8,4,4,126,48,78,39,26,13,61,45
23-06-2020 13:00:00,5,4,1,129,61,68,51,29,22,62,49
23-06-2020 14:00:00,6,4,2,121,67,54,45,26,19,62,61
23-06-2020 15:00:00,9,7,2,120,52,68,63,35,28,92,44
23-06-2020 16:00:00,10,1,9,177,95,82,89,41,48,146,79
23-06-2020 17:00:00,17,9,8,255,144,111,90,45,45,154,64
23-06-2020 18:00:00,10,5,5,239,122,117,71,38,33,157,63
23-06-2020 19:00:00,6,3,3,160,75,85,49,33,16,96,66
23-06-2020 20:00:00,9,5,4,115,62,53,40,20,20,50,53
23-06-2020 21:00:00,6,5,1,115,57,58,36,19,17,51,37
23-06-2020 22:00:00,9,6,3,85,53,32,24,12,12,37,23
23-06-2020 23:00:00,7,2,5,24,14,10,16,5,11,11,7
24-06-2020 00:00:00,0,0,0,8,4,4,5,3,2,14,12
24-06-2020 01:00:00,0,0,0,10,6,4,1,0,1,2,5
24-06-2020 02:00:00,0,0,0,3,2,1,2,0,2,4,2
24-06-2020 03:00:00,1,0,1,10,6,4,2,1,1,0,0
24-06-2020 04:00:00,2,0,2,10,3,7,1,1,0,0,7
24-06-2020 05:00:00,2,2,0,15,2,13,8,8,0,5,8
24-06-2020 06:00:00,6,5,1,93,17,76,64,56,8,16,65
24-06-2020 07:00:00,10,9,1,206,62,144,87,69,18,35,121
24-06-2020 08:00:00,4,4,0,232,70,162,85,77,8,33,152
24-06-2020 09:00:00,3,3,0,133,39,94,63,55,8,29,98
24-06-2020 10:00:00,5,5,0,101,35,66,41,36,5,28,56
24-06-2020 11:00:00,4,2,2,109,38,71,46,35,11,40,64
24-06-2020 12:00:00,10,7,3,164,74,90,60,39,21,65,66
24-06-2020 13:00:00,11,9,2,139,57,82,67,32,35,67,63
24-06-2020 14:00:00,15,10,5,148,63,85,61,38,23,77,46
24-06-2020 15:00:00,6,3,3,146,66,80,63,41,22,97,50
24-06-2020 16:00:00,14,4,10,214,117,97,74,44,30,143,58
24-06-2020 17:00:00,12,4,8,339,172,167,121,59,62,271,100
24-06-2020 18:00:00,14,4,10,281,142,139,128,69,59,186,69
24-06-2020 19:00:00,15,4,11,292,136,156,97,64,33,100,94
24-06-2020 20:00:00,13,5,8,206,113,93,70,40,30,87,117
24-06-2020 21:00:00,9,4,5,160,106,54,61,30,31,55,68
24-06-2020 22:00:00,1,1,0,92,62,30,31,14,17,40,44
24-06-2020 23:00:00,0,0,0,29,16,13,13,4,9,29,15
25-06-2020 00:00:00,0,0,0,21,15,6,11,5,6,8,6
25-06-2020 01:00:00,1,0,1,9,6,3,7,5,2,18,7
25-06-2020 02:00:00,0,0,0,3,2,1,2,0,2,4,1
25-06-2020 03:00:00,1,0,1,6,3,3,1,1,0,1,0
25-06-2020 04:00:00,1,1,0,7,2,5,1,1,0,2,5
25-06-2020 05:00:00,0,0,0,19,5,14,9,8,1,8,9
25-06-2020 06:00:00,5,4,1,91,25,66,70,63,7,24,71
25-06-2020 07:00:00,10,6,4,195,59,136,90,80,10,35,120
25-06-2020 08:00:00,4,3,1,226,60,166,84,78,6,33,157
25-06-2020 09:00:00,8,5,3,150,43,107,56,46,10,38,93
25-06-2020 10:00:00,10,7,3,110,28,82,31,18,13,60,54
25-06-2020 11:00:00,11,7,4,129,39,90,56,45,11,58,59
25-06-2020 12:00:00,6,6,0,164,61,103,56,36,20,105,69
25-06-2020 13:00:00,14,10,4,201,79,122,81,46,35,116,65
25-06-2020 14:00:00,9,6,3,200,82,118,71,43,28,145,91
25-06-2020 15:00:00,17,10,7,188,82,106,85,45,40,158,82
25-06-2020 16:00:00,8,5,3,255,121,134,95,49,46,166,97
25-06-2020 17:00:00,20,11,9,359,184,175,126,84,42,224,115
25-06-2020 18:00:00,13,6,7,327,155,172,102,54,48,218,145
25-06-2020 19:00:00,22,10,12,291,169,122,71,39,32,120,86
25-06-2020 20:00:00,11,3,8,185,104,81,67,29,38,92,101
25-06-2020 21:00:00,11,4,7,142,86,56,51,29,22,63,81
25-06-2020 22:00:00,7,6,1,76,52,24,37,18,19,44,31
25-06-2020 23:00:00,2,1,1,55,28,27,27,16,11,24,4
26-06-2020 00:00:00,0,0,0,24,17,7,4,3,1,10,8
26-06-2020 01:00:00,2,1,1,15,9,6,1,1,0,5,3
26-06-2020 02:00:00,0,0,0,5,2,3,1,1,0,2,1
26-06-2020 03:00:00,0,0,0,5,2,3,1,1,0,3,1
26-06-2020 04:00:00,0,0,0,8,4,4,1,1,0,4,5
26-06-2020 05:00:00,2,1,1,20,5,15,6,6,0,4,13
26-06-2020 06:00:00,4,4,0,71,12,59,69,63,6,17,61
26-06-2020 07:00:00,5,4,1,172,49,123,78,65,13,24,101
26-06-2020 08:00:00,7,6,1,212,62,150,91,84,7,32,139
26-06-2020 09:00:00,5,4,1,115,25,90,49,41,8,29,73
26-06-2020 10:00:00,6,5,1,89,23,66,34,24,10,33,57
26-06-2020 11:00:00,7,6,1,124,43,81,39,32,7,55,55
26-06-2020 12:00:00,4,2,2,183,65,118,57,40,17,68,57
26-06-2020 13:00:00,15,9,6,192,89,103,79,43,36,77,59
26-06-2020 14:00:00,5,2,3,174,73,101,59,35,24,88,46
26-06-2020 15:00:00,11,10,1,148,83,65,53,29,24,96,70
26-06-2020 16:00:00,12,7,5,229,114,115,67,37,30,135,59
26-06-2020 17:00:00,9,4,5,291,148,143,94,60,34,171,84
26-06-2020 18:00:00,11,6,5,242,103,139,94,62,32,151,104
26-06-2020 19:00:00,14,8,6,207,105,102,77,44,33,104,75
26-06-2020 20:00:00,5,4,1,149,68,81,53,31,22,63,45
26-06-2020 21:00:00,3,1,2,106,75,31,42,17,25,60,27
26-06-2020 22:00:00,5,4,1,82,59,23,26,18,8,46,21
26-06-2020 23:00:00,5,4,1,38,19,19,28,14,14,32,12
27-06-2020 00:00:00,4,2,2,35,25,10,10,2,8,33,7
27-06-2020 01:00:00,0,0,0,21,13,8,5,5,0,11,7
27-06-2020 02:00:00,0,0,0,11,4,7,2,2,0,3,3
27-06-2020 03:00:00,0,0,0,15,9,6,1,1,0,3,1
27-06-2020 04:00:00,0,0,0,7,3,4,2,2,0,1,2
27-06-2020 05:00:00,1,1,0,11,4,7,4,2,2,6,5
27-06-2020 06:00:00,2,1,1,27,4,23,18,15,3,8,18
27-06-2020 07:00:00,1,1,0,53,10,43,34,32,2,17,33
27-06-2020 08:00:00,9,8,1,50,15,35,32,25,7,37,33
27-06-2020 09:00:00,5,5,0,58,16,42,38,30,8,23,26
27-06-2020 10:00:00,6,3,3,69,29,40,35,24,11,30,20
27-06-2020 11:00:00,3,2,1,76,26,50,34,24,10,28,30
27-06-2020 12:00:00,3,1,2,81,41,40,32,24,8,34,24
27-06-2020 13:00:00,5,3,2,62,32,30,74,49,25,38,33
27-06-2020 14:00:00,4,0,4,116,56,60,67,40,27,46,41
27-06-2020 15:00:00,6,3,3,99,42,57,65,34,31,61,39
27-06-2020 16:00:00,10,3,7,116,59,57,49,28,21,57,61
27-06-2020 17:00:00,4,3,1,126,57,69,61,42,19,62,38
27-06-2020 18:00:00,7,6,1,120,60,60,65,44,21,62,57
27-06-2020 19:00:00,11,6,5,137,66,71,55,34,21,71,49
27-06-2020 20:00:00,8,5,3,83,42,41,32,20,12,44,35
27-06-2020 21:00:00,3,2,1,71,33,38,32,19,13,28,27
27-06-2020 22:00:00,0,0,0,70,41,29,23,9,14,22,20
27-06-2020 23:00:00,3,2,1,24,16,8,7,4,3,12,9
28-06-2020 00:00:00,1,0,1,21,7,14,3,2,1,7,9
28-06-2020 01:00:00,0,0,0,16,10,6,2,1,1,8,2
28-06-2020 02:00:00,1,0,1,8,4,4,6,2,4,2,1
28-06-2020 03:00:00,0,0,0,7,2,5,2,1,1,5,3
28-06-2020 04:00:00,0,0,0,16,9,7,0,0,0,3,5
28-06-2020 05:00:00,0,0,0,6,2,4,3,2,1,1,3
28-06-2020 06:00:00,1,0,1,21,7,14,7,5,2,5,12
28-06-2020 07:00:00,2,1,1,28,7,21,16,13,3,11,12
28-06-2020 08:00:00,2,2,0,29,7,22,21,16,5,16,17
28-06-2020 09:00:00,1,0,1,39,16,23,11,9,2,9,31
28-06-2020 10:00:00,1,1,0,65,22,43,27,18,9,27,22
28-06-2020 11:00:00,2,2,0,50,23,27,32,23,9,25,30
28-06-2020 12:00:00,7,2,5,61,25,36,34,23,11,49,38
28-06-2020 13:00:00,9,8,1,68,30,38,26,18,8,35,45
28-06-2020 14:00:00,3,2,1,90,39,51,47,32,15,38,28
28-06-2020 15:00:00,8,4,4,96,51,45,48,25,23,41,40
28-06-2020 16:00:00,8,2,6,86,39,47,46,23,23,54,40
28-06-2020 17:00:00,5,1,4,135,54,81,30,18,12,67,42
28-06-2020 18:00:00,8,5,3,94,45,49,48,29,19,60,49
28-06-2020 19:00:00,8,3,5,88,49,39,28,15,13,42,41
28-06-2020 20:00:00,5,2,3,70,44,26,38,27,11,30,38
28-06-2020 21:00:00,4,1,3,56,33,23,26,17,9,23,15
28-06-2020 22:00:00,5,3,2,40,30,10,10,5,5,16,5
28-06-2020 23:00:00,1,1,0,11,5,6,4,3,1,10,1
29-06-2020 00:00:00,2,0,2,4,0,4,3,3,0,2,3
29-06-2020 01:00:00,2,2,0,4,2,2,2,1,1,2,1
29-06-2020 02:00:00,0,0,0,1,1,0,0,0,0,0,0
29-06-2020 03:00:00,2,0,2,5,3,2,2,1,1,3,0
29-06-2020 04:00:00,0,0,0,10,3,7,0,0,0,3,4
29-06-2020 05:00:00,2,2,0,20,7,13,9,7,2,2,13
29-06-2020 06:00:00,7,5,2,60,9,51,71,61,10,8,54
29-06-2020 07:00:00,9,6,3,146,40,106,77,67,10,14,107
29-06-2020 08:00:00,5,5,0,179,49,130,81,73,8,24,139
29-06-2020 09:00:00,1,1,0,107,32,75,43,39,4,16,84
29-06-2020 10:00:00,6,4,2,67,21,46,25,20,5,15,35
29-06-2020 11:00:00,5,1,4,76,21,55,25,18,7,17,29
29-06-2020 12:00:00,8,0,8,97,36,61,40,28,12,37,35
29-06-2020 13:00:00,12,6,6,104,51,53,32,19,13,43,41
29-06-2020 14:00:00,6,2,4,95,43,52,41,28,13,61,52
29-06-2020 15:00:00,14,2,12,103,57,46,37,22,15,69,38
29-06-2020 16:00:00,6,3,3,155,69,86,53,17,36,109,35
29-06-2020 17:00:00,10,4,6,232,135,97,79,48,31,161,56
29-06-2020 18:00:00,13,8,5,181,106,75,83,45,38,119,49
29-06-2020 19:00:00,12,6,6,156,83,73,55,30,25,71,41
29-06-2020 20:00:00,10,6,4,88,45,43,54,24,30,47,23
29-06-2020 21:00:00,6,4,2,50,34,16,32,15,17,44,10
29-06-2020 22:00:00,2,1,1,47,25,22,19,9,10,21,9
29-06-2020 23:00:00,0,0,0,29,20,9,17,9,8,17,8
30-06-2020 00:00:00,0,0,0,13,9,4,3,1,2,4,6
30-06-2020 01:00:00,0,0,0,6,6,0,2,1,1,8,0
30-06-2020 02:00:00,0,0,0,5,2,3,2,2,0,0,0
30-06-2020 03:00:00,2,1,1,7,5,2,1,1,0,0,1
30-06-2020 04:00:00,1,0,1,7,1,6,0,0,0,1,7
30-06-2020 05:00:00,2,2,0,24,7,17,8,7,1,4,15
30-06-2020 06:00:00,5,5,0,93,16,77,78,67,11,17,63
30-06-2020 07:00:00,6,5,1,189,63,126,99,91,8,27,131
30-06-2020 08:00:00,5,4,1,258,69,189,94,88,6,31,152
30-06-2020 09:00:00,6,4,2,139,30,109,55,47,8,32,94
30-06-2020 10:00:00,1,1,0,107,39,68,25,18,7,25,53
30-06-2020 11:00:00,3,1,2,97,28,69,49,33,16,34,68
30-06-2020 12:00:00,6,4,2,141,53,88,36,22,14,43,57
30-06-2020 13:00:00,15,8,7,158,79,79,63,42,21,75,63
30-06-2020 14:00:00,8,2,6,131,54,77,50,30,20,68,52
30-06-2020 15:00:00,14,2,12,156,84,72,67,38,29,93,53
30-06-2020 16:00:00,10,9,1,175,86,89,79,37,42,141,78
30-06-2020 17:00:00,16,7,9,269,149,120,88,50,38,192,80
30-06-2020 18:00:00,20,13,7,279,155,124,111,60,51,206,51
30-06-2020 19:00:00,11,3,8,203,108,95,47,29,18,112,47
30-06-2020 20:00:00,4,2,2,141,75,66,72,41,31,58,59
30-06-2020 21:00:00,5,1,4,84,43,41,40,14,26,44,33
30-06-2020 22:00:00,3,3,0,67,42,25,20,12,8,35,24
30-06-2020 23:00:00,5,3,2,29,19,10,12,3,9,34,20
01-07-2020 00:00:00,1,1,0,18,13,5,4,2,2,10,9
01-07-2020 01:00:00,0,0,0,11,7,4,4,0,4,4,2
01-07-2020 02:00:00,0,0,0,2,2,0,0,0,0,1,2
01-07-2020 03:00:00,0,0,0,6,3,3,2,2,0,3,1
01-07-2020 04:00:00,1,0,1,12,5,7,0,0,0,2,3
01-07-2020 05:00:00,0,0,0,22,5,17,5,5,0,3,15
01-07-2020 06:00:00,3,3,0,83,14,69,75,69,6,19,72
01-07-2020 07:00:00,6,2,4,189,55,134,94,78,16,24,132
01-07-2020 08:00:00,8,7,1,235,64,171,91,82,9,36,159
01-07-2020 09:00:00,4,2,2,135,31,104,50,43,7,27,74
01-07-2020 10:00:00,1,1,0,66,21,45,17,13,4,20,36
01-07-2020 11:00:00,2,2,0,72,25,47,32,23,9,20,22
01-07-2020 12:00:00,5,4,1,97,37,60,34,22,12,34,29
01-07-2020 13:00:00,4,4,0,111,53,58,41,31,10,51,40
01-07-2020 14:00:00,7,4,3,93,40,53,28,21,7,45,30
01-07-2020 15:00:00,4,2,2,110,53,57,36,21,15,65,31
01-07-2020 16:00:00,6,2,4,151,79,72,67,37,30,118,38
01-07-2020 17:00:00,6,5,1,253,149,104,68,27,41,165,45
01-07-2020 18:00:00,4,3,1,189,112,77,80,37,43,136,36
01-07-2020 19:00:00,8,7,1,143,80,63,49,30,19,79,26
01-07-2020 20:00:00,3,2,1,94,48,46,34,15,19,50,21
01-07-2020 21:00:00,3,0,3,55,30,25,17,6,11,26,16
01-07-2020 22:00:00,0,0,0,35,26,9,14,7,7,28,11
01-07-2020 23:00:00,0,0,0,20,13,7,8,4,4,23,5
02-07-2020 00:00:00,1,0,1,13,8,5,0,0,0,8,6
02-07-2020 01:00:00,0,0,0,7,4,3,0,0,0,4,3
02-07-2020 02:00:00,1,0,1,4,3,1,0,0,0,0,1
02-07-2020 03:00:00,0,0,0,7,2,5,1,1,0,0,0
02-07-2020 04:00:00,2,1,1,10,2,8,1,1,0,3,4
02-07-2020 05:00:00,0,0,0,19,5,14,5,4,1,3,13
02-07-2020 06:00:00,4,4,0,100,20,80,80,71,9,16,68
02-07-2020 07:00:00,6,4,2,194,47,147,92,84,8,23,109
02-07-2020 08:00:00,6,6,0,231,62,169,98,91,7,28,154
02-07-2020 09:00:00,5,2,3,142,31,111,64,55,9,26,82
02-07-2020 10:00:00,6,2,4,97,38,59,40,33,7,21,45
02-07-2020 11:00:00,8,5,3,99,36,63,49,37,12,33,60
02-07-2020 12:00:00,11,8,3,138,48,90,61,35,26,60,68
02-07-2020 13:00:00,8,4,4,162,77,85,61,45,16,59,55
02-07-2020 14:00:00,7,2,5,145,65,80,43,27,16,85,55
02-07-2020 15:00:00,15,7,8,164,74,90,74,42,32,82,50
02-07-2020 16:00:00,10,5,5,232,129,103,85,49,36,126,65
02-07-2020 17:00:00,11,5,6,272,146,126,79,39,40,180,75
02-07-2020 18:00:00,16,5,11,278,154,124,110,61,49,178,90
02-07-2020 19:00:00,15,5,10,216,115,101,71,39,32,89,71
02-07-2020 20:00:00,11,5,6,156,80,76,68,35,33,83,60
02-07-2020 21:00:00,12,4,8,139,85,54,52,29,23,58,36
02-07-2020 22:00:00,4,1,3,76,46,30,30,9,21,58,20
02-07-2020 23:00:00,1,0,1,52,33,19,16,11,5,33,10
03-07-2020 00:00:00,2,0,2,23,17,6,8,2,6,17,6
03-07-2020 01:00:00,0,0,0,3,2,1,3,2,1,1,5
03-07-2020 02:00:00,2,0,2,6,3,3,0,0,0,2,2
03-07-2020 03:00:00,0,0,0,5,2,3,1,1,0,3,1
03-07-2020 04:00:00,2,1,1,6,3,3,3,3,0,4,3
03-07-2020 05:00:00,0,0,0,24,5,19,3,3,0,6,11
03-07-2020 06:00:00,4,4,0,78,10,68,66,58,8,16,53
03-07-2020 07:00:00,7,5,2,161,41,120,85,77,8,11,87
03-07-2020 08:00:00,11,9,2,174,39,135,74,66,8,24,95
03-07-2020 09:00:00,1,1,0,108,29,79,52,45,7,22,72
03-07-2020 10:00:00,4,2,2,77,25,52,29,22,7,15,52
03-07-2020 11:00:00,7,6,1,102,31,71,46,35,11,29,35
03-07-2020 12:00:00,10,7,3,122,54,68,48,35,13,43,38
03-07-2020 13:00:00,3,2,1,118,57,61,40,23,17,40,28
03-07-2020 14:00:00,4,2,2,125,50,75,35,18,17,35,28
03-07-2020 15:00:00,6,3,3,102,54,48,54,34,20,77,34
03-07-2020 16:00:00,6,3,3,169,89,80,57,32,25,88,28
03-07-2020 17:00:00,7,6,1,214,113,101,73,45,28,126,57
03-07-2020 18:00:00,4,1,3,192,97,95,55,35,20,108,65
03-07-2020 19:00:00,7,5,2,161,78,83,64,41,23,75,47
03-07-2020 20:00:00,5,4,1,140,74,66,58,37,21,53,46
03-07-2020 21:00:00,6,3,3,89,54,35,40,15,25,44,30
03-07-2020 22:00:00,4,3,1,78,47,31,31,12,19,39,27
03-07-2020 23:00:00,3,1,2,51,35,16,20,11,9,28,14
04-07-2020 00:00:00,0,0,0,26,15,11,13,7,6,13,9
04-07-2020 01:00:00,0,0,0,21,17,4,8,5,3,13,3
04-07-2020 02:00:00,2,1,1,8,5,3,1,0,1,8,3
04-07-2020 03:00:00,0,0,0,9,6,3,2,1,1,5,0
04-07-2020 04:00:00,2,1,1,11,2,9,1,1,0,1,4
04-07-2020 05:00:00,0,0,0,12,1,11,4,3,1,8,8
04-07-2020 06:00:00,2,1,1,36,9,27,18,16,2,10,22
04-07-2020 07:00:00,1,1,0,60,15,45,31,29,2,11,45
04-07-2020 08:00:00,3,2,1,64,23,41,31,26,5,14,34
04-07-2020 09:00:00,7,5,2,89,30,59,20,13,7,33,38
04-07-2020 10:00:00,3,1,2,99,26,73,37,28,9,47,46
04-07-2020 11:00:00,3,2,1,136,44,92,48,40,8,25,56
04-07-2020 12:00:00,3,3,0,125,44,81,43,21,22,62,74
04-07-2020 13:00:00,5,2,3,153,64,89,63,37,26,85,82
04-07-2020 14:00:00,12,11,1,140,57,83,55,35,20,60,62
04-07-2020 15:00:00,5,2,3,116,57,59,32,22,10,64,63
04-07-2020 16:00:00,4,3,1,125,48,77,44,33,11,78,52
04-07-2020 17:00:00,9,7,2,144,72,72,57,27,30,68,45
04-07-2020 18:00:00,5,4,1,141,70,71,43,28,15,77,63
04-07-2020 19:00:00,6,3,3,129,63,66,37,21,16,72,54
04-07-2020 20:00:00,9,6,3,119,68,51,41,17,24,49,58
04-07-2020 21:00:00,4,3,1,78,47,31,23,12,11,55,43
04-07-2020 22:00:00,1,0,1,80,50,30,35,26,9,33,31
04-07-2020 23:00:00,0,0,0,45,29,16,29,13,16,39,15
05-07-2020 00:00:00,0,0,0,24,15,9,12,4,8,20,10
05-07-2020 01:00:00,0,0,0,23,10,13,3,1,2,7,2
05-07-2020 02:00:00,1,0,1,10,7,3,7,5,2,9,2
05-07-2020 03:00:00,1,0,1,9,6,3,1,0,1,3,5
05-07-2020 04:00:00,2,0,2,9,2,7,0,0,0,3,1
05-07-2020 05:00:00,1,1,0,7,1,6,3,2,1,5,3
05-07-2020 06:00:00,1,0,1,15,2,13,10,10,0,8,6
05-07-2020 07:00:00,1,1,0,34,11,23,11,9,2,16,13
05-07-2020 08:00:00,0,0,0,48,18,30,18,12,6,16,28
05-07-2020 09:00:00,5,3,2,53,21,32,29,20,9,24,25
05-07-2020 10:00:00,4,2,2,72,27,45,31,26,5,32,32
05-07-2020 11:00:00,5,4,1,81,32,49,31,22,9,40,28
05-07-2020 12:00:00,4,2,2,105,41,64,45,26,19,46,43
05-07-2020 13:00:00,10,5,5,104,41,63,44,27,17,46,63
05-07-2020 14:00:00,6,6,0,86,39,47,42,26,16,51,63
05-07-2020 15:00:00,6,6,0,105,43,62,29,14,15,38,35
05-07-2020 16:00:00,5,2,3,89,33,56,37,22,15,46,37
05-07-2020 17:00:00,6,4,2,88,37,51,38,23,15,42,31
05-07-2020 18:00:00,4,2,2,100,48,52,47,31,16,45,45
05-07-2020 19:00:00,4,1,3,85,49,36,40,25,15,54,40
05-07-2020 20:00:00,2,1,1,98,61,37,44,25,19,37,37
05-07-2020 21:00:00,5,1,4,46,26,20,20,13,7,26,20
05-07-2020 22:00:00,5,3,2,47,32,15,19,9,10,29,22
05-07-2020 23:00:00,3,1,2,17,11,6,12,4,8,16,7
06-07-2020 00:00:00,0,0,0,4,2,2,3,1,2,7,3
06-07-2020 01:00:00,2,2,0,7,3,4,3,2,1,2,1
06-07-2020 02:00:00,0,0,0,6,5,1,1,0,1,1,1
06-07-2020 03:00:00,0,0,0,4,2,2,1,1,0,2,3
06-07-2020 04:00:00,0,0,0,8,4,4,1,1,0,2,3
06-07-2020 05:00:00,2,2,0,24,4,20,10,7,3,4,13
06-07-2020 06:00:00,4,4,0,89,14,75,78,70,8,14,73
06-07-2020 07:00:00,5,5,0,170,56,114,79,65,14,29,111
06-07-2020 08:00:00,12,8,4,214,40,174,94,88,6,25,143
06-07-2020 09:00:00,3,2,1,121,22,99,43,38,5,24,62
06-07-2020 10:00:00,4,3,1,86,32,54,28,22,6,24,31
06-07-2020 11:00:00,2,2,0,103,34,69,39,25,14,46,47
06-07-2020 12:00:00,8,3,5,122,47,75,50,33,17,46,46
06-07-2020 13:00:00,8,6,2,109,54,55,44,26,18,70,55
06-07-2020 14:00:00,15,8,7,104,46,58,46,27,19,70,49
06-07-2020 15:00:00,15,6,9,159,82,77,45,26,19,78,51
06-07-2020 16:00:00,10,5,5,189,100,89,53,27,26,112,62
06-07-2020 17:00:00,10,4,6,260,157,103,97,52,45,177,37
06-07-2020 18:00:00,17,14,3,221,114,107,78,48,30,160,53
06-07-2020 19:00:00,7,5,2,156,94,62,59,33,26,117,53
06-07-2020 20:00:00,6,6,0,130,71,59,55,31,24,78,63
06-07-2020 21:00:00,8,4,4,71,45,26,34,19,15,36,38
06-07-2020 22:00:00,1,1,0,64,39,25,27,17,10,35,25
06-07-2020 23:00:00,2,2,0,35,23,12,6,3,3,26,13
07-07-2020 00:00:00,1,0,1,10,6,4,3,2,1,9,6
07-07-2020 01:00:00,0,0,0,6,3,3,1,0,1,6,2
07-07-2020 02:00:00,0,0,0,2,1,1,2,1,1,4,4
07-07-2020 03:00:00,0,0,0,7,3,4,1,1,0,3,1
07-07-2020 04:00:00,0,0,0,5,2,3,2,2,0,4,5
07-07-2020 05:00:00,1,1,0,20,5,15,4,4,0,3,14
07-07-2020 06:00:00,4,4,0,71,13,58,74,67,7,10,63
07-07-2020 07:00:00,6,5,1,131,29,102,69,58,11,25,85
07-07-2020 08:00:00,9,7,2,201,46,155,91,82,9,23,135
07-07-2020 09:00:00,5,3,2,128,24,104,39,35,4,23,63
07-07-2020 10:00:00,7,3,4,73,15,58,24,18,6,13,42
07-07-2020 11:00:00,3,0,3,65,19,46,21,16,5,11,22
07-07-2020 12:00:00,2,2,0,86,33,53,32,22,10,28,24
07-07-2020 13:00:00,5,3,2,67,37,30,24,15,9,26,14
07-07-2020 14:00:00,5,4,1,69,30,39,26,15,11,48,25
07-07-2020 15:00:00,11,8,3,91,49,42,42,20,22,55,26
07-07-2020 16:00:00,6,5,1,130,81,49,39,21,18,85,39
07-07-2020 17:00:00,2,0,2,183,110,73,55,32,23,155,53
07-07-2020 18:00:00,9,7,2,145,96,49,46,21,25,118,20
07-07-2020 19:00:00,6,1,5,118,73,45,42,22,20,59,22
07-07-2020 20:00:00,3,3,0,79,44,35,29,15,14,31,25
07-07-2020 21:00:00,4,2,2,53,30,23,18,11,7,17,17
07-07-2020 22:00:00,4,4,0,28,17,11,12,5,7,19,13
07-07-2020 23:00:00,0,0,0,16,12,4,3,1,2,14,3
08-07-2020 00:00:00,1,1,0,7,5,2,1,0,1,4,5
08-07-2020 01:00:00,0,0,0,8,6,2,0,0,0,2,1
08-07-2020 02:00:00,0,0,0,3,2,1,1,0,1,0,0
08-07-2020 03:00:00,0,0,0,4,1,3,0,0,0,1,1
08-07-2020 04:00:00,0,0,0,6,2,4,2,2,0,3,3
08-07-2020 05:00:00,2,1,1,23,5,18,5,3,2,4,11
08-07-2020 06:00:00,3,3,0,82,16,66,73,65,8,15,63
08-07-2020 07:00:00,3,2,1,153,37,116,74,64,10,24,101
08-07-2020 08:00:00,9,6,3,202,60,142,96,80,16,23,140
08-07-2020 09:00:00,4,3,1,122,19,103,58,50,8,31,82
08-07-2020 10:00:00,6,4,2,68,27,41,30,23,7,14,42
08-07-2020 11:00:00,2,1,1,78,16,62,38,27,11,27,49
08-07-2020 12:00:00,8,8,0,122,55,67,52,40,12,40,45
08-07-2020 13:00:00,5,2,3,109,54,55,42,29,13,60,45
08-07-2020 14:00:00,5,3,2,89,47,42,28,14,14,39,45
08-07-2020 15:00:00,12,7,5,94,42,52,33,13,20,59,34
08-07-2020 16:00:00,4,1,3,124,77,47,43,27,16,93,45
08-07-2020 17:00:00,7,2,5,211,125,86,51,28,23,145,55
08-07-2020 18:00:00,5,2,3,166,106,60,53,35,18,90,27
08-07-2020 19:00:00,5,4,1,122,65,57,36,23,13,61,12
08-07-2020 20:00:00,3,1,2,59,29,30,29,10,19,39,16
08-07-2020 21:00:00,5,2,3,63,38,25,19,6,13,30,12
08-07-2020 22:00:00,2,1,1,19,15,4,13,6,7,28,16
08-07-2020 23:00:00,1,1,0,18,14,4,7,3,4,15,4
09-07-2020 00:00:00,1,0,1,12,11,1,3,1,2,9,3
09-07-2020 01:00:00,0,0,0,8,4,4,0,0,0,0,1
09-07-2020 02:00:00,0,0,0,4,2,2,0,0,0,2,1
09-07-2020 03:00:00,0,0,0,4,1,3,0,0,0,1,0
09-07-2020 04:00:00,1,1,0,6,0,6,2,2,0,2,5
09-07-2020 05:00:00,0,0,0,18,2,16,4,4,0,3,6
09-07-2020 06:00:00,1,1,0,71,11,60,78,73,5,14,60
09-07-2020 07:00:00,5,4,1,152,42,110,91,74,17,20,90
09-07-2020 08:00:00,9,8,1,199,46,153,87,78,9,23,118
09-07-2020 09:00:00,4,3,1,139,31,108,44,35,9,27,95
09-07-2020 10:00:00,2,2,0,75,26,49,27,25,2,19,43
09-07-2020 11:00:00,4,3,1,97,29,68,33,24,9,33,27
09-07-2020 12:00:00,4,3,1,155,60,95,32,23,9,43,51
09-07-2020 13:00:00,9,7,2,108,48,60,54,31,23,59,56
09-07-2020 14:00:00,6,3,3,129,58,71,54,30,24,59,44
09-07-2020 15:00:00,5,4,1,143,84,59,52,25,27,75,44
09-07-2020 16:00:00,11,6,5,180,99,81,69,44,25,122,67
09-07-2020 17:00:00,17,9,8,233,137,96,75,37,38,185,72
09-07-2020 18:00:00,13,8,5,239,132,107,90,59,31,181,62
09-07-2020 19:00:00,9,4,5,185,87,98,57,34,23,117,56
09-07-2020 20:00:00,5,2,3,133,71,62,48,18,30,61,55
09-07-2020 21:00:00,7,3,4,116,59,57,38,25,13,28,16
09-07-2020 22:00:00,5,3,2,77,45,32,29,12,17,35,22
09-07-2020 23:00:00,1,1,0,46,30,16,13,7,6,34,10
10-07-2020 00:00:00,0,0,0,22,20,2,9,5,4,18,3
10-07-2020 01:00:00,0,0,0,13,9,4,3,2,1,8,5
10-07-2020 02:00:00,0,0,0,5,3,2,0,0,0,4,1
10-07-2020 03:00:00,1,0,1,7,2,5,0,0,0,2,0
10-07-2020 04:00:00,1,1,0,11,4,7,4,4,0,2,4
10-07-2020 05:00:00,2,0,2,23,7,16,6,6,0,8,10
10-07-2020 06:00:00,4,4,0,89,19,70,80,72,8,15,64
10-07-2020 07:00:00,4,2,2,170,43,127,82,67,15,29,98
10-07-2020 08:00:00,7,6,1,237,54,183,91,80,11,37,157
10-07-2020 09:00:00,5,5,0,124,28,96,62,53,9,26,85
10-07-2020 10:00:00,7,6,1,104,25,79,38,29,9,25,77
10-07-2020 11:00:00,4,2,2,123,42,81,41,28,13,35,54
10-07-2020 12:00:00,13,9,4,145,62,83,54,38,16,71,62
10-07-2020 13:00:00,13,8,5,152,65,87,53,27,26,79,63
10-07-2020 14:00:00,6,2,4,143,65,78,47,26,21,84,67
10-07-2020 15:00:00,3,3,0,153,72,81,62,29,33,85,54
10-07-2020 16:00:00,13,7,6,193,93,100,84,53,31,108,59
10-07-2020 17:00:00,12,6,6,229,116,113,75,41,34,146,71
10-07-2020 18:00:00,9,8,1,214,105,109,81,39,42,137,59
10-07-2020 19:00:00,7,2,5,202,113,89,66,38,28,101,58
10-07-2020 20:00:00,5,5,0,157,77,80,41,24,17,72,83
10-07-2020 21:00:00,3,2,1,122,68,54,40,22,18,50,30
10-07-2020 22:00:00,2,1,1,67,43,24,32,14,18,55,28
10-07-2020 23:00:00,1,0,1,58,46,12,19,4,15,25,14
11-07-2020 00:00:00,1,1,0,46,26,20,11,4,7,31,5
11-07-2020 01:00:00,0,0,0,10,4,6,2,1,1,13,11
11-07-2020 02:00:00,1,1,0,13,10,3,1,0,1,15,5
11-07-2020 03:00:00,1,0,1,7,3,4,1,1,0,6,2
11-07-2020 04:00:00,1,1,0,15,7,8,1,1,0,4,3
11-07-2020 05:00:00,0,0,0,12,5,7,3,2,1,6,5
11-07-2020 06:00:00,1,0,1,37,9,28,22,20,2,11,33
11-07-2020 07:00:00,4,2,2,41,11,30,27,25,2,20,34
11-07-2020 08:00:00,5,2,3,62,26,36,36,29,7,21,32
11-07-2020 09:00:00,4,3,1,94,35,59,35,30,5,45,57
11-07-2020 10:00:00,5,4,1,122,33,89,49,33,16,74,77
11-07-2020 11:00:00,7,4,3,120,43,77,40,29,11,63,74
11-07-2020 12:00:00,18,4,14,168,60,108,67,36,31,78,74
11-07-2020 13:00:00,7,5,2,163,79,84,73,48,25,92,85
11-07-2020 14:00:00,18,15,3,164,72,92,55,30,25,76,83
11-07-2020 15:00:00,12,7,5,146,61,85,42,27,15,88,70
11-07-2020 16:00:00,13,6,7,123,50,73,45,29,16,77,83
11-07-2020 17:00:00,13,8,5,156,65,91,43,29,14,75,71
11-07-2020 18:00:00,4,3,1,131,72,59,69,37,32,78,77
11-07-2020 19:00:00,7,3,4,119,72,47,48,24,24,61,52
11-07-2020 20:00:00,9,4,5,112,66,46,40,29,11,51,44
11-07-2020 21:00:00,4,3,1,84,54,30,46,28,18,54,35
11-07-2020 22:00:00,4,3,1,77,41,36,36,18,18,48,26
11-07-2020 23:00:00,0,0,0,55,36,19,16,7,9,34,14
12-07-2020 00:00:00,0,0,0,36,18,18,16,8,8,28,11
12-07-2020 01:00:00,0,0,0,27,18,9,6,1,5,10,7
12-07-2020 02:00:00,0,0,0,16,6,10,5,3,2,5,6
12-07-2020 03:00:00,0,0,0,8,7,1,1,1,0,3,4
12-07-2020 04:00:00,1,0,1,8,2,6,0,0,0,3,2
12-07-2020 05:00:00,0,0,0,7,2,5,5,4,1,8,3
12-07-2020 06:00:00,1,0,1,26,8,18,6,5,1,7,11
12-07-2020 07:00:00,1,1,0,40,11,29,14,12,2,9,16
12-07-2020 08:00:00,2,2,0,48,12,36,27,19,8,18,39
12-07-2020 09:00:00,10,9,1,57,18,39,21,15,6,26,36
12-07-2020 10:00:00,5,4,1,101,32,69,41,25,16,42,33
12-07-2020 11:00:00,4,2,2,99,34,65,42,22,20,67,36
12-07-2020 12:00:00,12,10,2,130,60,70,59,36,23,92,53
12-07-2020 13:00:00,9,6,3,152,57,95,50,30,20,72,49
12-07-2020 14:00:00,10,6,4,134,60,74,71,44,27,79,56
12-07-2020 15:00:00,12,9,3,112,49,63,56,34,22,63,53
12-07-2020 16:00:00,10,3,7,117,57,60,67,38,29,54,47
12-07-2020 17:00:00,5,4,1,144,68,76,61,40,21,73,86
12-07-2020 18:00:00,11,3,8,124,60,64,60,33,27,80,67
12-07-2020 19:00:00,15,5,10,133,64,69,40,29,11,70,49
12-07-2020 20:00:00,3,2,1,113,56,57,38,20,18,50,49
12-07-2020 21:00:00,8,6,2,94,56,38,21,16,5,42,44
12-07-2020 22:00:00,2,1,1,64,44,20,28,9,19,39,24
12-07-2020 23:00:00,0,0,0,28,19,9,15,6,9,16,10
13-07-2020 00:00:00,0,0,0,8,5,3,4,2,2,9,3
13-07-2020 01:00:00,0,0,0,9,7,2,1,0,1,3,1
13-07-2020 02:00:00,0,0,0,5,4,1,0,0,0,2,3
13-07-2020 03:00:00,0,0,0,5,3,2,1,1,0,3,2
13-07-2020 04:00:00,0,0,0,6,3,3,1,1,0,3,3
13-07-2020 05:00:00,1,0,1,23,5,18,7,6,1,4,18
13-07-2020 06:00:00,5,5,0,93,16,77,81,71,10,9,81
13-07-2020 07:00:00,12,9,3,189,54,135,109,92,17,15,125
13-07-2020 08:00:00,4,3,1,215,62,153,97,86,11,30,155
13-07-2020 09:00:00,6,4,2,118,31,87,45,40,5,26,84
13-07-2020 10:00:00,3,3,0,84,24,60,36,31,5,23,49
13-07-2020 11:00:00,8,7,1,79,22,57,36,26,10,22,34
13-07-2020 12:00:00,3,3,0,104,31,73,35,22,13,43,46
13-07-2020 13:00:00,15,10,5,95,46,49,39,27,12,69,55
13-07-2020 14:00:00,12,7,5,125,59,66,37,20,17,66,32
13-07-2020 15:00:00,14,8,6,143,68,75,45,20,25,75,41
13-07-2020 16:00:00,13,8,5,204,114,90,78,48,30,135,55
13-07-2020 17:00:00,19,9,10,293,154,139,112,54,58,205,75
13-07-2020 18:00:00,12,8,4,233,146,87,95,52,43,162,56
13-07-2020 19:00:00,8,3,5,146,84,62,55,31,24,79,60
13-07-2020 20:00:00,6,3,3,88,44,44,46,24,22,63,47
13-07-2020 21:00:00,11,7,4,90,53,37,36,21,15,43,20
13-07-2020 22:00:00,10,4,6,52,32,20,26,11,15,28,22
13-07-2020 23:00:00,1,1,0,22,19,3,9,3,6,29,5
14-07-2020 00:00:00,1,0,1,15,9,6,0,0,0,3,8
14-07-2020 01:00:00,1,0,1,9,6,3,3,3,0,2,1
14-07-2020 02:00:00,0,0,0,3,1,2,1,1,0,2,0
14-07-2020 03:00:00,0,0,0,8,5,3,0,0,0,0,0
14-07-2020 04:00:00,0,0,0,9,3,6,2,2,0,3,6
14-07-2020 05:00:00,2,1,1,29,7,22,5,4,1,7,14
14-07-2020 06:00:00,5,5,0,95,16,79,83,73,10,7,72
14-07-2020 07:00:00,12,6,6,195,63,132,106,88,18,26,127
14-07-2020 08:00:00,10,6,4,248,70,178,105,93,12,33,180
14-07-2020 09:00:00,8,5,3,154,31,123,47,40,7,27,82
14-07-2020 10:00:00,3,0,3,88,30,58,45,35,10,23,60
14-07-2020 11:00:00,4,2,2,92,33,59,29,24,5,39,43
14-07-2020 12:00:00,8,5,3,105,30,75,45,27,18,57,53
14-07-2020 13:00:00,2,1,1,94,48,46,45,32,13,45,31
14-07-2020 14:00:00,10,6,4,81,40,41,35,24,11,51,33
14-07-2020 15:00:00,6,2,4,116,73,43,33,16,17,55,47
14-07-2020 16:00:00,7,4,3,131,73,58,57,34,23,107,41
14-07-2020 17:00:00,4,3,1,225,136,89,52,31,21,151,40
14-07-2020 18:00:00,8,5,3,208,117,91,63,40,23,156,31
14-07-2020 19:00:00,4,1,3,119,67,52,51,33,18,76,29
14-07-2020 20:00:00,4,1,3,82,46,36,42,23,19,48,40
14-07-2020 21:00:00,2,2,0,69,45,24,32,17,15,34,22
14-07-2020 22:00:00,6,2,4,44,29,15,17,7,10,40,15
14-07-2020 23:00:00,2,2,0,18,13,5,13,6,7,12,8
15-07-2020 00:00:00,0,0,0,12,8,4,5,1,4,7,3
15-07-2020 01:00:00,0,0,0,3,1,2,0,0,0,3,0
15-07-2020 02:00:00,0,0,0,6,4,2,0,0,0,1,2
15-07-2020 03:00:00,0,0,0,5,3,2,2,2,0,1,0
15-07-2020 04:00:00,0,0,0,8,2,6,3,3,0,1,3
15-07-2020 05:00:00,3,2,1,27,5,22,6,4,2,4,12
15-07-2020 06:00:00,5,5,0,85,17,68,86,79,7,12,76
15-07-2020 07:00:00,6,4,2,188,48,140,87,74,13,23,125
15-07-2020 08:00:00,9,7,2,227,60,167,111,101,10,32,176
15-07-2020 09:00:00,6,5,1,136,24,112,57,54,3,22,95
15-07-2020 10:00:00,6,5,1,95,26,69,32,23,9,24,48
15-07-2020 11:00:00,4,2,2,94,31,63,57,41,16,34,44
15-07-2020 12:00:00,8,4,4,102,37,65,54,31,23,60,42
15-07-2020 13:00:00,8,7,1,135,48,87,59,45,14,59,46
15-07-2020 14:00:00,13,12,1,124,58,66,49,27,22,76,46
15-07-2020 15:00:00,13,8,5,156,79,77,42,17,25,107,51
15-07-2020 16:00:00,8,6,2,176,99,77,57,31,26,122,55
15-07-2020 17:00:00,12,8,4,279,154,125,108,61,47,195,71
15-07-2020 18:00:00,9,8,1,285,138,147,98,60,38,180,73
15-07-2020 19:00:00,10,3,7,190,105,85,52,25,27,115,61
15-07-2020 20:00:00,10,2,8,141,74,67,46,19,27,77,48
15-07-2020 21:00:00,7,6,1,111,68,43,40,21,19,63,40
15-07-2020 22:00:00,2,1,1,66,44,22,40,22,18,49,36
15-07-2020 23:00:00,5,2,3,45,29,16,21,12,9,33,18
16-07-2020 00:00:00,2,0,2,19,15,4,6,2,4,13,9
16-07-2020 01:00:00,0,0,0,4,2,2,2,1,1,6,2
16-07-2020 02:00:00,0,0,0,8,5,3,2,1,1,2,5
16-07-2020 03:00:00,1,0,1,6,3,3,2,1,1,3,1
16-07-2020 04:00:00,6,6,0,7,1,6,3,3,0,6,6
16-07-2020 05:00:00,3,3,0,27,6,21,9,7,2,8,17
16-07-2020 06:00:00,6,5,1,106,27,79,79,68,11,14,79
16-07-2020 07:00:00,5,3,2,224,72,152,110,95,15,29,122
16-07-2020 08:00:00,11,8,3,270,62,208,92,83,9,37,165
16-07-2020 09:00:00,4,3,1,147,34,113,58,52,6,26,107
16-07-2020 10:00:00,3,2,1,82,18,64,31,23,8,32,60
16-07-2020 11:00:00,6,3,3,118,39,79,45,34,11,41,47
16-07-2020 12:00:00,10,5,5,143,52,91,60,47,13,48,49
16-07-2020 13:00:00,13,6,7,131,58,73,61,36,25,80,74
16-07-2020 14:00:00,12,5,7,147,61,86,74,46,28,85,56
16-07-2020 15:00:00,14,9,5,156,93,63,57,29,28,94,45
16-07-2020 16:00:00,18,13,5,196,103,93,91,55,36,136,66
16-07-2020 17:00:00,22,12,10,305,163,142,131,72,59,224,70
16-07-2020 18:00:00,15,5,10,279,138,141,128,70,58,198,65
16-07-2020 19:00:00,16,7,9,225,103,122,73,45,28,114,82
16-07-2020 20:00:00,19,11,8,157,99,58,56,26,30,83,77
16-07-2020 21:00:00,12,8,4,110,70,40,39,22,17,76,60
16-07-2020 22:00:00,9,4,5,85,56,29,45,19,26,47,37
16-07-2020 23:00:00,2,0,2,48,33,15,26,8,18,49,15
17-07-2020 00:00:00,1,0,1,25,16,9,6,5,1,32,7
17-07-2020 01:00:00,0,0,0,13,8,5,9,6,3,5,6
17-07-2020 02:00:00,0,0,0,9,5,4,0,0,0,1,0
17-07-2020 03:00:00,1,0,1,8,3,5,1,1,0,2,2
17-07-2020 04:00:00,0,0,0,12,2,10,6,5,1,6,4
17-07-2020 05:00:00,2,1,1,23,6,17,8,7,1,5,15
17-07-2020 06:00:00,4,3,1,97,13,84,80,67,13,16,62
17-07-2020 07:00:00,13,7,6,157,48,109,103,87,16,27,125
17-07-2020 08:00:00,6,6,0,216,68,148,92,82,10,34,141
17-07-2020 09:00:00,6,5,1,126,29,97,43,37,6,23,80
17-07-2020 10:00:00,11,9,2,94,27,67,44,33,11,31,51
17-07-2020 11:00:00,3,3,0,115,36,79,45,34,11,43,34
17-07-2020 12:00:00,5,2,3,149,54,95,56,37,19,56,70
17-07-2020 13:00:00,7,4,3,128,55,73,63,41,22,67,52
17-07-2020 14:00:00,6,5,1,135,61,74,48,25,23,63,52
17-07-2020 15:00:00,9,7,2,156,75,81,68,24,44,77,59
17-07-2020 16:00:00,22,19,3,163,84,79,66,43,23,110,63
17-07-2020 17:00:00,14,9,5,229,126,103,96,62,34,155,60
17-07-2020 18:00:00,13,6,7,234,127,107,68,39,29,121,69
17-07-2020 19:00:00,6,3,3,170,75,95,56,26,30,97,62
17-07-2020 20:00:00,1,1,0,138,64,74,59,32,27,58,54
17-07-2020 21:00:00,9,5,4,136,80,56,40,25,15,39,19
17-07-2020 22:00:00,5,3,2,59,42,17,35,17,18,38,22
17-07-2020 23:00:00,4,2,2,41,25,16,18,9,9,54,12
18-07-2020 00:00:00,1,0,1,41,27,14,15,5,10,13,4
18-07-2020 01:00:00,1,1,0,20,12,8,9,5,4,13,6
18-07-2020 02:00:00,0,0,0,13,9,4,3,1,2,11,0
18-07-2020 03:00:00,0,0,0,4,2,2,1,0,1,2,2
18-07-2020 04:00:00,1,1,0,10,4,6,2,2,0,3,4
18-07-2020 05:00:00,0,0,0,11,2,9,5,4,1,2,4
18-07-2020 06:00:00,4,3,1,35,10,25,21,20,1,6,16
18-07-2020 07:00:00,2,0,2,45,14,31,32,29,3,6,23
18-07-2020 08:00:00,2,1,1,60,15,45,23,21,2,19,39
18-07-2020 09:00:00,4,4,0,48,14,34,26,18,8,21,33
18-07-2020 10:00:00,6,4,2,102,31,71,29,24,5,28,36
18-07-2020 11:00:00,13,10,3,119,30,89,37,22,15,43,52
18-07-2020 12:00:00,6,4,2,161,64,97,52,28,24,63,49
18-07-2020 13:00:00,21,13,8,171,73,98,83,44,39,89,67
18-07-2020 14:00:00,15,9,6,160,67,93,70,42,28,94,83
18-07-2020 15:00:00,11,6,5,176,75,101,64,40,24,73,81
18-07-2020 16:00:00,15,10,5,140,57,83,49,35,14,70,91
18-07-2020 17:00:00,14,5,9,134,52,82,63,37,26,97,79
18-07-2020 18:00:00,7,5,2,156,85,71,62,40,22,93,81
18-07-2020 19:00:00,10,4,6,123,58,65,44,32,12,72,55
18-07-2020 20:00:00,4,3,1,107,56,51,36,23,13,60,54
18-07-2020 21:00:00,9,4,5,89,51,38,33,18,15,59,36
18-07-2020 22:00:00,3,2,1,84,52,32,31,15,16,45,28
18-07-2020 23:00:00,0,0,0,47,36,11,20,10,10,53,18
19-07-2020 00:00:00,4,2,2,34,24,10,14,3,11,27,7
19-07-2020 01:00:00,1,0,1,23,16,7,6,4,2,18,4
19-07-2020 02:00:00,1,1,0,18,8,10,4,4,0,14,5
19-07-2020 03:00:00,0,0,0,9,7,2,1,1,0,4,4
19-07-2020 04:00:00,0,0,0,12,5,7,1,1,0,5,6
19-07-2020 05:00:00,1,1,0,8,3,5,3,2,1,1,5
19-07-2020 06:00:00,0,0,0,25,7,18,8,7,1,10,16
19-07-2020 07:00:00,1,1,0,52,19,33,22,18,4,15,20
19-07-2020 08:00:00,0,0,0,63,18,45,29,26,3,31,29
19-07-2020 09:00:00,4,1,3,74,24,50,33,25,8,33,35
19-07-2020 10:00:00,8,4,4,96,26,70,59,30,29,73,48
19-07-2020 11:00:00,4,4,0,150,50,100,62,37,25,62,48
19-07-2020 12:00:00,12,6,6,136,48,88,69,45,24,79,65
19-07-2020 13:00:00,23,16,7,191,85,106,86,52,34,82,75
19-07-2020 14:00:00,13,11,2,159,68,91,73,45,28,89,68
19-07-2020 15:00:00,5,2,3,129,56,73,82,40,42,76,72
19-07-2020 16:00:00,11,7,4,129,64,65,45,27,18,85,80
19-07-2020 17:00:00,14,7,7,138,61,77,62,35,27,68,63
19-07-2020 18:00:00,9,5,4,141,66,75,70,42,28,97,53
19-07-2020 19:00:00,13,8,5,141,73,68,67,37,30,68,52
19-07-2020 20:00:00,7,3,4,141,79,62,45,21,24,44,56
19-07-2020 21:00:00,5,4,1,90,55,35,35,19,16,50,56
19-07-2020 22:00:00,4,2,2,64,46,18,29,16,13,36,30
19-07-2020 23:00:00,2,2,0,29,22,7,20,7,13,27,17
20-07-2020 00:00:00,2,2,0,15,7,8,4,1,3,16,2
20-07-2020 01:00:00,1,1,0,6,4,2,1,1,0,5,0
20-07-2020 02:00:00,0,0,0,5,5,0,1,0,1,3,0
20-07-2020 03:00:00,0,0,0,4,3,1,1,1,0,2,1
20-07-2020 04:00:00,2,2,0,12,4,8,2,2,0,5,5
20-07-2020 05:00:00,2,0,2,28,4,24,11,10,1,3,19
20-07-2020 06:00:00,5,5,0,97,15,82,83,75,8,16,73
20-07-2020 07:00:00,5,2,3,184,52,132,101,79,22,28,122
20-07-2020 08:00:00,10,7,3,259,67,192,107,100,7,39,170
20-07-2020 09:00:00,8,7,1,139,26,113,60,44,16,30,91
20-07-2020 10:00:00,6,3,3,114,39,75,43,32,11,28,73
20-07-2020 11:00:00,0,0,0,106,41,65,44,30,14,48,61
20-07-2020 12:00:00,8,4,4,118,45,73,32,29,3,48,43
20-07-2020 13:00:00,16,11,5,134,67,67,62,45,17,65,68
20-07-2020 14:00:00,8,5,3,131,56,75,48,29,19,71,77
20-07-2020 15:00:00,10,5,5,133,67,66,56,22,34,99,56
20-07-2020 16:00:00,10,8,2,186,99,87,64,32,32,152,62
20-07-2020 17:00:00,8,4,4,286,160,126,104,63,41,205,60
20-07-2020 18:00:00,13,7,6,270,143,127,103,69,34,170,40
20-07-2020 19:00:00,13,9,4,188,93,95,62,39,23,103,69
20-07-2020 20:00:00,13,7,6,132,68,64,63,33,30,70,50
20-07-2020 21:00:00,9,4,5,93,59,34,40,23,17,37,21
20-07-2020 22:00:00,8,8,0,54,32,22,44,21,23,44,24
20-07-2020 23:00:00,1,0,1,30,16,14,16,9,7,22,8
21-07-2020 00:00:00,1,1,0,14,8,6,6,3,3,13,14
21-07-2020 01:00:00,0,0,0,6,6,0,3,1,2,4,1
21-07-2020 02:00:00,0,0,0,5,1,4,1,1,0,5,1
21-07-2020 03:00:00,0,0,0,5,1,4,1,1,0,2,1
21-07-2020 04:00:00,1,0,1,12,3,9,2,2,0,4,3
21-07-2020 05:00:00,2,2,0,26,7,19,12,12,0,5,12
21-07-2020 06:00:00,8,7,1,104,15,89,86,76,10,10,76
21-07-2020 07:00:00,7,2,5,223,69,154,126,102,24,31,155
21-07-2020 08:00:00,10,7,3,302,85,217,112,102,10,33,198
21-07-2020 09:00:00,8,6,2,172,26,146,55,44,11,38,101
21-07-2020 10:00:00,5,3,2,106,35,71,32,26,6,40,71
21-07-2020 11:00:00,11,9,2,133,61,72,47,39,8,45,66
21-07-2020 12:00:00,4,2,2,142,50,92,57,38,19,51,59
21-07-2020 13:00:00,12,9,3,152,68,84,57,35,22,65,66
21-07-2020 14:00:00,6,4,2,145,71,74,57,40,17,81,71
21-07-2020 15:00:00,7,3,4,163,83,80,58,30,28,103,47
21-07-2020 16:00:00,9,7,2,176,102,74,89,49,40,136,75
21-07-2020 17:00:00,14,9,5,314,168,146,124,68,56,240,67
21-07-2020 18:00:00,18,6,12,299,171,128,127,67,60,196,87
21-07-2020 19:00:00,16,10,6,218,111,107,63,42,21,150,53
21-07-2020 20:00:00,7,3,4,163,92,71,49,28,21,86,45
21-07-2020 21:00:00,5,3,2,120,69,51,43,27,16,39,38
21-07-2020 22:00:00,4,2,2,67,39,28,30,15,15,50,16
21-07-2020 23:00:00,4,2,2,42,31,11,15,5,10,22,8
22-07-2020 00:00:00,1,1,0,21,15,6,6,2,4,18,10
22-07-2020 01:00:00,0,0,0,11,7,4,6,4,2,8,2
22-07-2020 02:00:00,0,0,0,6,2,4,0,0,0,2,2
22-07-2020 03:00:00,0,0,0,4,2,2,0,0,0,2,0
22-07-2020 04:00:00,1,0,1,9,3,6,3,3,0,3,4
22-07-2020 05:00:00,1,1,0,19,2,17,8,6,2,4,12
22-07-2020 06:00:00,4,4,0,89,19,70,58,52,6,10,54
22-07-2020 07:00:00,6,3,3,160,45,115,87,68,19,23,106
22-07-2020 08:00:00,6,4,2,266,58,208,102,89,13,27,162
22-07-2020 09:00:00,6,4,2,129,25,104,42,35,7,24,80
22-07-2020 10:00:00,5,4,1,90,28,62,24,20,4,23,54
22-07-2020 11:00:00,5,4,1,101,38,63,36,24,12,34,29
22-07-2020 12:00:00,4,2,2,128,48,80,61,42,19,38,61
22-07-2020 13:00:00,7,3,4,119,48,71,42,30,12,68,60
22-07-2020 14:00:00,3,2,1,106,50,56,33,14,19,62,38
22-07-2020 15:00:00,11,6,5,127,60,67,45,25,20,75,52
22-07-2020 16:00:00,14,8,6,175,99,76,73,35,38,115,54
22-07-2020 17:00:00,17,10,7,300,177,123,89,41,48,185,75
22-07-2020 18:00:00,9,6,3,223,121,102,79,47,32,193,77
22-07-2020 19:00:00,5,3,2,163,80,83,56,29,27,89,59
22-07-2020 20:00:00,4,2,2,128,69,59,61,36,25,59,50
22-07-2020 21:00:00,3,3,0,92,63,29,30,11,19,42,39
22-07-2020 22:00:00,8,4,4,56,41,15,33,15,18,37,21
22-07-2020 23:00:00,0,0,0,49,29,20,17,7,10,34,14
23-07-2020 00:00:00,2,2,0,20,11,9,5,1,4,19,7
23-07-2020 01:00:00,1,0,1,8,5,3,2,2,0,6,4
23-07-2020 02:00:00,0,0,0,6,4,2,1,1,0,4,0
23-07-2020 03:00:00,1,0,1,4,1,3,3,2,1,2,0
23-07-2020 04:00:00,2,0,2,10,4,6,1,1,0,1,4
23-07-2020 05:00:00,1,1,0,23,2,21,12,10,2,3,17
23-07-2020 06:00:00,6,4,2,95,22,73,74,65,9,11,70
23-07-2020 07:00:00,4,1,3,173,48,125,82,74,8,21,92
23-07-2020 08:00:00,4,4,0,235,50,185,99,83,16,31,140
23-07-2020 09:00:00,2,2,0,126,33,93,47,40,7,15,85
23-07-2020 10:00:00,3,2,1,69,22,47,31,24,7,16,41
23-07-2020 11:00:00,7,6,1,96,24,72,39,29,10,22,31
23-07-2020 12:00:00,4,2,2,116,40,76,42,27,15,39,34
23-07-2020 13:00:00,8,4,4,137,63,74,50,33,17,55,48
23-07-2020 14:00:00,11,4,7,110,54,56,42,25,17,54,48
23-07-2020 15:00:00,14,9,5,151,83,68,44,23,21,77,38
23-07-2020 16:00:00,13,10,3,168,95,73,84,50,34,102,51
23-07-2020 17:00:00,10,4,6,267,146,121,98,52,46,178,73
23-07-2020 18:00:00,12,6,6,240,115,125,104,60,44,153,48
23-07-2020 19:00:00,18,6,12,191,92,99,61,39,22,90,45
23-07-2020 20:00:00,4,1,3,154,89,65,42,15,27,59,53
23-07-2020 21:00:00,3,2,1,124,73,51,34,18,16,45,32
23-07-2020 22:00:00,4,4,0,74,52,22,39,20,19,50,33
23-07-2020 23:00:00,4,2,2,48,33,15,17,5,12,30,5
24-07-2020 00:00:00,0,0,0,34,22,12,8,3,5,15,7
24-07-2020 01:00:00,0,0,0,14,6,8,3,3,0,6,4
24-07-2020 02:00:00,0,0,0,5,3,2,3,3,0,4,1
24-07-2020 03:00:00,0,0,0,2,0,2,1,1,0,1,1
24-07-2020 04:00:00,2,0,2,9,4,5,4,3,1,3,5
24-07-2020 05:00:00,1,1,0,23,3,20,9,6,3,7,12
24-07-2020 06:00:00,5,5,0,111,17,94,67,61,6,16,70
24-07-2020 07:00:00,4,2,2,185,58,127,109,86,23,25,99
24-07-2020 08:00:00,4,4,0,251,67,184,84,76,8,32,163
24-07-2020 09:00:00,5,3,2,139,42,97,56,45,11,29,87
24-07-2020 10:00:00,1,1,0,95,33,62,38,30,8,32,61
24-07-2020 11:00:00,4,2,2,111,33,78,48,37,11,47,52
24-07-2020 12:00:00,10,4,6,116,41,75,44,32,12,45,56
24-07-2020 13:00:00,10,6,4,167,76,91,86,50,36,67,49
24-07-2020 14:00:00,6,4,2,168,86,82,47,27,20,93,66
24-07-2020 15:00:00,7,3,4,153,101,52,59,34,25,96,52
24-07-2020 16:00:00,10,5,5,144,79,65,54,28,26,103,43
24-07-2020 17:00:00,8,3,5,207,101,106,59,25,34,121,37
24-07-2020 18:00:00,8,4,4,162,83,79,55,33,22,117,25
24-07-2020 19:00:00,11,4,7,161,83,78,65,38,27,84,46
24-07-2020 20:00:00,6,2,4,131,65,66,50,33,17,66,51
24-07-2020 21:00:00,2,1,1,98,51,47,55,28,27,37,26
24-07-2020 22:00:00,5,2,3,45,29,16,25,15,10,39,24
24-07-2020 23:00:00,0,0,0,49,35,14,14,5,9,30,17
25-07-2020 00:00:00,0,0,0,21,13,8,15,4,11,16,6
25-07-2020 01:00:00,1,1,0,11,8,3,5,4,1,9,4
25-07-2020 02:00:00,0,0,0,15,10,5,1,1,0,10,2
25-07-2020 03:00:00,1,1,0,11,6,5,3,0,3,2,0
25-07-2020 04:00:00,0,0,0,8,5,3,2,1,1,2,2
25-07-2020 05:00:00,1,1,0,7,2,5,4,4,0,2,9
25-07-2020 06:00:00,0,0,0,43,8,35,19,18,1,9,16
25-07-2020 07:00:00,5,4,1,58,15,43,30,25,5,14,25
25-07-2020 08:00:00,7,3,4,86,30,56,33,28,5,14,37
25-07-2020 09:00:00,5,3,2,84,37,47,37,31,6,31,53
25-07-2020 10:00:00,5,3,2,92,23,69,45,29,16,41,50
25-07-2020 11:00:00,9,7,2,115,39,76,46,31,15,41,51
25-07-2020 12:00:00,11,8,3,108,36,72,46,27,19,56,49
25-07-2020 13:00:00,9,6,3,150,56,94,54,29,25,82,57
25-07-2020 14:00:00,11,8,3,134,58,76,71,43,28,89,66
25-07-2020 15:00:00,7,4,3,103,47,56,56,40,16,58,67
25-07-2020 16:00:00,13,9,4,116,50,66,50,31,19,57,60
25-07-2020 17:00:00,2,0,2,92,53,39,32,21,11,38,24
25-07-2020 18:00:00,4,2,2,105,56,49,43,29,14,61,31
25-07-2020 19:00:00,10,5,5,115,54,61,42,27,15,58,39
25-07-2020 20:00:00,3,3,0,98,44,54,28,22,6,38,45
25-07-2020 21:00:00,4,2,2,68,33,35,32,22,10,34,32
25-07-2020 22:00:00,6,4,2,64,36,28,26,12,14,40,28
25-07-2020 23:00:00,0,0,0,42,24,18,20,8,12,41,23
26-07-2020 00:00:00,1,1,0,39,26,13,9,2,7,16,12
26-07-2020 01:00:00,0,0,0,9,6,3,5,1,4,8,4
26-07-2020 02:00:00,1,0,1,8,6,2,1,1,0,14,6
26-07-2020 03:00:00,0,0,0,12,6,6,1,0,1,3,0
26-07-2020 04:00:00,2,0,2,3,1,2,2,2,0,8,3
26-07-2020 05:00:00,1,1,0,8,3,5,4,2,2,3,7
26-07-2020 06:00:00,1,1,0,21,6,15,11,10,1,8,11
26-07-2020 07:00:00,3,2,1,37,11,26,26,21,5,20,22
26-07-2020 08:00:00,1,1,0,68,32,36,25,19,6,17,27
26-07-2020 09:00:00,5,2,3,66,20,46,27,21,6,25,49
26-07-2020 10:00:00,11,7,4,101,35,66,41,30,11,38,56
26-07-2020 11:00:00,10,6,4,111,39,72,50,36,14,55,58
26-07-2020 12:00:00,15,10,5,105,38,67,61,39,22,75,61
26-07-2020 13:00:00,4,2,2,157,68,89,36,22,14,69,70
26-07-2020 14:00:00,10,5,5,112,53,59,64,32,32,56,62
26-07-2020 15:00:00,12,7,5,110,45,65,49,32,17,80,50
26-07-2020 16:00:00,7,4,3,117,54,63,50,38,12,70,76
26-07-2020 17:00:00,13,7,6,133,65,68,52,35,17,65,58
26-07-2020 18:00:00,2,1,1,117,61,56,57,39,18,62,58
26-07-2020 19:00:00,7,3,4,144,74,70,53,32,21,57,38
26-07-2020 20:00:00,13,7,6,90,50,40,46,31,15,40,36
26-07-2020 21:00:00,5,4,1,94,61,33,29,10,19,53,31
26-07-2020 22:00:00,3,1,2,39,28,11,25,8,17,32,5
26-07-2020 23:00:00,3,0,3,27,21,6,10,5,5,19,5
27-07-2020 00:00:00,2,0,2,12,7,5,3,2,1,7,1
27-07-2020 01:00:00,0,0,0,5,3,2,1,1,0,2,1
27-07-2020 02:00:00,0,0,0,3,1,2,0,0,0,1,0
27-07-2020 03:00:00,0,0,0,6,3,3,2,2,0,7,0
27-07-2020 04:00:00,0,0,0,4,3,1,1,1,0,0,3
27-07-2020 05:00:00,1,1,0,19,2,17,5,5,0,1,13
27-07-2020 06:00:00,5,5,0,83,14,69,52,48,4,6,50
27-07-2020 07:00:00,3,2,1,130,29,101,72,61,11,16,84
27-07-2020 08:00:00,10,6,4,209,61,148,79,70,9,19,124
27-07-2020 09:00:00,7,4,3,123,20,103,43,36,7,23,67
27-07-2020 10:00:00,2,1,1,75,31,44,24,21,3,12,36
27-07-2020 11:00:00,8,5,3,88,28,60,39,29,10,30,22
27-07-2020 12:00:00,1,1,0,101,34,67,46,32,14,33,44
27-07-2020 13:00:00,9,7,2,99,39,60,51,30,21,45,40
27-07-2020 14:00:00,5,5,0,92,45,47,34,22,12,56,42
27-07-2020 15:00:00,11,4,7,120,48,72,52,30,22,62,51
27-07-2020 16:00:00,13,7,6,157,78,79,53,29,24,94,47
27-07-2020 17:00:00,11,6,5,284,148,136,112,69,43,169,51
27-07-2020 18:00:00,15,11,4,225,122,103,82,47,35,159,55
27-07-2020 19:00:00,11,8,3,182,92,90,61,34,27,80,48
27-07-2020 20:00:00,13,6,7,104,56,48,43,19,24,57,27
27-07-2020 21:00:00,4,2,2,79,57,22,32,14,18,30,32
27-07-2020 22:00:00,1,1,0,48,35,13,28,13,15,41,15
27-07-2020 23:00:00,1,0,1,24,16,8,12,5,7,27,10
28-07-2020 00:00:00,0,0,0,10,5,5,3,3,0,8,9
28-07-2020 01:00:00,1,0,1,6,5,1,1,0,1,5,3
28-07-2020 02:00:00,0,0,0,4,1,3,0,0,0,8,0
28-07-2020 03:00:00,0,0,0,4,2,2,2,1,1,1,0
28-07-2020 04:00:00,1,0,1,6,2,4,1,1,0,4,3
28-07-2020 05:00:00,1,0,1,35,4,31,9,8,1,3,11
28-07-2020 06:00:00,5,4,1,106,17,89,78,72,6,14,77
28-07-2020 07:00:00,4,4,0,213,64,149,103,90,13,26,134
28-07-2020 08:00:00,13,8,5,261,65,196,97,88,9,37,185
28-07-2020 09:00:00,10,9,1,154,39,115,65,55,10,24,96
28-07-2020 10:00:00,6,5,1,97,33,64,24,22,2,23,70
28-07-2020 11:00:00,11,6,5,98,31,67,53,41,12,42,42
28-07-2020 12:00:00,14,6,8,114,37,77,59,34,25,45,44
28-07-2020 13:00:00,12,7,5,125,45,80,97,55,42,72,52
28-07-2020 14:00:00,9,5,4,144,63,81,92,48,44,49,48
28-07-2020 15:00:00,9,5,4,144,80,64,106,56,50,75,44
28-07-2020 16:00:00,15,7,8,197,98,99,121,57,64,141,64
28-07-2020 17:00:00,9,5,4,325,184,141,124,66,58,207,72
28-07-2020 18:00:00,12,8,4,282,150,132,83,51,32,197,69
28-07-2020 19:00:00,17,8,9,188,103,85,57,28,29,119,56
28-07-2020 20:00:00,9,3,6,125,72,53,45,21,24,61,51
28-07-2020 21:00:00,8,3,5,78,42,36,29,16,13,61,51
28-07-2020 22:00:00,3,1,2,63,51,12,39,18,21,32,23
28-07-2020 23:00:00,4,1,3,24,17,7,15,4,11,30,9
29-07-2020 00:00:00,0,0,0,15,12,3,6,4,2,7,9
29-07-2020 01:00:00,0,0,0,9,3,6,5,4,1,6,3
29-07-2020 02:00:00,0,0,0,8,3,5,2,0,2,4,2
29-07-2020 03:00:00,0,0,0,7,1,6,1,1,0,2,0
29-07-2020 04:00:00,0,0,0,12,2,10,1,1,0,0,3
29-07-2020 05:00:00,0,0,0,29,7,22,14,10,4,5,15
29-07-2020 06:00:00,6,5,1,115,19,96,65,60,5,9,72
29-07-2020 07:00:00,7,4,3,183,47,136,106,92,14,28,117
29-07-2020 08:00:00,15,11,4,284,67,217,103,98,5,35,184
29-07-2020 09:00:00,12,9,3,163,39,124,59,51,8,38,114
29-07-2020 10:00:00,3,3,0,90,26,64,24,17,7,23,54
29-07-2020 11:00:00,8,6,2,86,20,66,53,35,18,34,40
29-07-2020 12:00:00,11,7,4,116,38,78,92,51,41,53,61
29-07-2020 13:00:00,9,7,2,124,53,71,87,60,27,62,56
29-07-2020 14:00:00,8,6,2,104,54,50,64,32,32,64,53
29-07-2020 15:00:00,10,5,5,120,67,53,52,27,25,89,54
29-07-2020 16:00:00,15,9,6,177,99,78,49,28,21,130,47
29-07-2020 17:00:00,8,6,2,283,176,107,113,57,56,168,37
29-07-2020 18:00:00,15,6,9,262,146,116,82,47,35,154,54
29-07-2020 19:00:00,9,4,5,168,77,91,53,31,22,99,45
29-07-2020 20:00:00,5,1,4,118,60,58,51,29,22,65,61
29-07-2020 21:00:00,4,3,1,95,59,36,37,18,19,54,21
29-07-2020 22:00:00,2,2,0,57,41,16,26,13,13,26,22
29-07-2020 23:00:00,1,0,1,45,33,12,12,3,9,34,8
30-07-2020 00:00:00,0,0,0,23,18,5,7,2,5,22,4
30-07-2020 01:00:00,0,0,0,11,6,5,4,2,2,2,3
30-07-2020 02:00:00,0,0,0,3,1,2,0,0,0,6,2
30-07-2020 03:00:00,1,0,1,4,1,3,1,1,0,1,2
30-07-2020 04:00:00,0,0,0,7,1,6,2,1,1,0,4
30-07-2020 05:00:00,0,0,0,29,4,25,10,7,3,3,9
30-07-2020 06:00:00,5,5,0,93,12,81,58,50,8,9,45
30-07-2020 07:00:00,8,6,2,164,47,117,88,77,11,16,94
30-07-2020 08:00:00,10,8,2,269,60,209,99,91,8,29,173
30-07-2020 09:00:00,6,5,1,158,41,117,57,50,7,18,81
30-07-2020 10:00:00,2,2,0,97,27,70,40,32,8,26,61
30-07-2020 11:00:00,6,3,3,104,34,70,42,27,15,43,47
30-07-2020 12:00:00,5,3,2,117,36,81,68,47,21,54,69
30-07-2020 13:00:00,6,4,2,136,67,69,54,39,15,65,63
30-07-2020 14:00:00,8,6,2,137,58,79,48,26,22,72,49
30-07-2020 15:00:00,6,4,2,130,65,65,58,30,28,67,41
30-07-2020 16:00:00,16,9,7,181,93,88,68,37,31,120,60
30-07-2020 17:00:00,7,4,3,299,183,116,183,86,97,188,86
30-07-2020 18:00:00,12,7,5,257,133,124,203,100,103,162,55
30-07-2020 19:00:00,11,5,6,201,104,97,157,95,62,107,47
30-07-2020 20:00:00,13,5,8,151,80,71,151,79,72,69,63
30-07-2020 21:00:00,8,4,4,110,62,48,105,58,47,60,40
30-07-2020 22:00:00,6,4,2,61,47,14,40,22,18,50,27
30-07-2020 23:00:00,1,0,1,50,36,14,21,7,14,43,11
31-07-2020 00:00:00,3,2,1,26,20,6,16,9,7,18,6
31-07-2020 01:00:00,1,1,0,7,6,1,3,2,1,14,2
31-07-2020 02:00:00,0,0,0,10,7,3,0,0,0,5,0
31-07-2020 03:00:00,1,0,1,5,2,3,0,0,0,1,2
31-07-2020 04:00:00,0,0,0,5,3,2,3,3,0,4,3
31-07-2020 05:00:00,0,0,0,29,10,19,10,9,1,10,17
31-07-2020 06:00:00,3,3,0,88,11,77,80,70,10,12,70
31-07-2020 07:00:00,5,3,2,179,55,124,85,75,10,34,99
31-07-2020 08:00:00,12,9,3,234,64,170,100,81,19,27,143
31-07-2020 09:00:00,10,6,4,146,32,114,60,50,10,32,78
31-07-2020 10:00:00,10,7,3,109,23,86,66,51,15,40,59
31-07-2020 11:00:00,7,3,4,126,45,81,60,38,22,49,48
31-07-2020 12:00:00,9,6,3,101,44,57,68,34,34,55,49
31-07-2020 13:00:00,13,7,6,144,70,74,64,41,23,78,49
31-07-2020 14:00:00,7,6,1,154,69,85,75,35,40,74,54
31-07-2020 15:00:00,11,4,7,136,64,72,80,54,26,94,39
31-07-2020 16:00:00,18,12,6,188,82,106,68,42,26,100,61
31-07-2020 17:00:00,15,9,6,231,133,98,134,74,60,154,89
31-07-2020 18:00:00,15,9,6,222,117,105,101,55,46,148,63
31-07-2020 19:00:00,20,14,6,205,93,112,107,68,39,87,68
31-07-2020 20:00:00,29,16,13,142,62,80,75,50,25,62,56
31-07-2020 21:00:00,10,3,7,132,65,67,58,32,26,68,46
31-07-2020 22:00:00,9,3,6,84,57,27,43,15,28,51,27
31-07-2020 23:00:00,6,2,4,53,39,14,19,4,15,43,15
01-08-2020 00:00:00,0,0,0,45,31,14,9,2,7,32,10
01-08-2020 01:00:00,1,0,1,19,14,5,5,0,5,8,7
01-08-2020 02:00:00,0,0,0,13,8,5,2,1,1,7,5
01-08-2020 03:00:00,1,0,1,7,4,3,2,2,0,4,0
01-08-2020 04:00:00,0,0,0,11,5,6,1,1,0,4,2
01-08-2020 05:00:00,0,0,0,12,3,9,3,2,1,3,6
01-08-2020 06:00:00,1,0,1,35,9,26,27,24,3,9,16
01-08-2020 07:00:00,4,2,2,44,12,32,24,16,8,18,29
01-08-2020 08:00:00,7,4,3,65,24,41,40,34,6,29,51
01-08-2020 09:00:00,6,3,3,85,27,58,56,35,21,43,60
01-08-2020 10:00:00,14,6,8,115,33,82,73,47,26,51,73
01-08-2020 11:00:00,18,16,2,132,44,88,57,31,26,83,53
01-08-2020 12:00:00,16,15,1,138,42,96,89,56,33,77,62
01-08-2020 13:00:00,28,18,10,134,56,78,92,64,28,73,53
01-08-2020 14:00:00,24,9,15,139,59,80,77,43,34,78,74
01-08-2020 15:00:00,23,10,13,114,62,52,90,55,35,66,46
01-08-2020 16:00:00,16,6,10,128,56,72,96,52,44,55,53
01-08-2020 17:00:00,12,7,5,120,54,66,74,40,34,59,56
01-08-2020 18:00:00,18,13,5,99,49,50,63,37,26,65,57
01-08-2020 19:00:00,2,1,1,107,54,53,45,28,17,59,40
01-08-2020 20:00:00,5,3,2,97,53,44,43,23,20,39,25
01-08-2020 21:00:00,12,5,7,62,32,30,28,16,12,46,35
01-08-2020 22:00:00,4,1,3,53,35,18,32,18,14,31,22
01-08-2020 23:00:00,2,1,1,37,28,9,28,13,15,24,16
02-08-2020 00:00:00,1,1,0,34,26,8,11,0,11,18,12
02-08-2020 01:00:00,1,1,0,11,7,4,2,1,1,13,4
02-08-2020 02:00:00,0,0,0,10,9,1,0,0,0,5,5
02-08-2020 03:00:00,0,0,0,4,2,2,1,1,0,9,0
02-08-2020 04:00:00,1,0,1,13,6,7,0,0,0,3,2
02-08-2020 05:00:00,0,0,0,14,3,11,2,2,0,6,3
02-08-2020 06:00:00,3,3,0,23,7,16,16,13,3,8,17
02-08-2020 07:00:00,2,2,0,38,11,27,20,17,3,17,16
02-08-2020 08:00:00,2,1,1,54,10,44,35,30,5,22,40
02-08-2020 09:00:00,10,5,5,66,18,48,47,39,8,36,30
02-08-2020 10:00:00,10,8,2,91,19,72,65,38,27,46,47
02-08-2020 11:00:00,19,11,8,103,33,70,78,53,25,43,41
02-08-2020 12:00:00,13,6,7,106,33,73,87,53,34,57,45
02-08-2020 13:00:00,20,14,6,127,54,73,113,68,45,87,76
02-08-2020 14:00:00,21,12,9,105,34,71,94,52,42,69,48
02-08-2020 15:00:00,30,19,11,117,58,59,109,69,40,79,72
02-08-2020 16:00:00,23,14,9,114,58,56,126,65,61,70,57
02-08-2020 17:00:00,22,7,15,96,43,53,73,41,32,65,52
02-08-2020 18:00:00,10,6,4,114,60,54,54,34,20,72,66
02-08-2020 19:00:00,14,2,12,115,57,58,60,33,27,45,60
02-08-2020 20:00:00,10,6,4,72,43,29,60,32,28,48,38
02-08-2020 21:00:00,7,3,4,59,35,24,34,17,17,42,31
02-08-2020 22:00:00,4,3,1,46,24,22,25,11,14,28,16
02-08-2020 23:00:00,2,1,1,30,18,12,13,7,6,34,9
03-08-2020 00:00:00,0,0,0,22,14,8,10,3,7,9,7
03-08-2020 01:00:00,0,0,0,3,1,2,3,1,2,9,2
03-08-2020 02:00:00,0,0,0,6,4,2,1,1,0,2,2
03-08-2020 03:00:00,0,0,0,7,5,2,0,0,0,2,2
03-08-2020 04:00:00,1,0,1,8,4,4,0,0,0,1,1
03-08-2020 05:00:00,1,1,0,7,3,4,0,0,0,0,6
03-08-2020 06:00:00,1,1,0,29,5,24,23,22,1,7,17
03-08-2020 07:00:00,1,1,0,46,10,36,33,28,5,10,25
03-08-2020 08:00:00,3,2,1,47,13,34,24,19,5,20,35
03-08-2020 09:00:00,5,2,3,59,25,34,49,26,23,33,37
03-08-2020 10:00:00,9,4,5,71,25,46,60,42,18,42,49
03-08-2020 11:00:00,20,7,13,106,37,69,85,63,22,51,74
03-08-2020 12:00:00,32,15,17,115,43,72,128,61,67,89,72
03-08-2020 13:00:00,29,17,12,103,43,60,111,70,41,71,74
03-08-2020 14:00:00,12,9,3,118,49,69,123,75,48,66,96
03-08-2020 15:00:00,29,17,12,108,52,56,116,59,57,92,72
03-08-2020 16:00:00,31,15,16,115,57,58,108,58,50,89,65
03-08-2020 17:00:00,20,4,16,149,63,86,76,38,38,92,68
03-08-2020 18:00:00,11,6,5,122,65,57,81,49,32,74,65
03-08-2020 19:00:00,20,9,11,113,61,52,69,41,28,58,59
03-08-2020 20:00:00,12,6,6,88,49,39,58,33,25,58,44
03-08-2020 21:00:00,8,6,2,77,38,39,32,19,13,35,27
03-08-2020 22:00:00,4,4,0,45,31,14,22,10,12,19,11
03-08-2020 23:00:00,1,1,0,28,17,11,11,3,8,28,7
04-08-2020 00:00:00,0,0,0,14,9,5,4,1,3,12,3
04-08-2020 01:00:00,2,1,1,8,3,5,2,0,2,3,1
04-08-2020 02:00:00,0,0,0,5,3,2,0,0,0,3,2
04-08-2020 03:00:00,0,0,0,3,1,2,0,0,0,1,0
04-08-2020 04:00:00,2,1,1,7,4,3,3,3,0,0,8
04-08-2020 05:00:00,1,1,0,21,3,18,8,8,0,6,17
04-08-2020 06:00:00,7,6,1,87,16,71,70,62,8,10,72
04-08-2020 07:00:00,7,7,0,171,43,128,91,76,15,27,96
04-08-2020 08:00:00,13,7,6,247,60,187,99,90,9,28,156
04-08-2020 09:00:00,6,5,1,121,30,91,73,63,10,28,80
04-08-2020 10:00:00,5,4,1,78,35,43,31,24,7,28,54
04-08-2020 11:00:00,6,4,2,90,30,60,56,44,12,43,44
04-08-2020 12:00:00,18,10,8,108,45,63,51,39,12,53,50
04-08-2020 13:00:00,12,7,5,113,53,60,67,44,23,68,41
04-08-2020 14:00:00,14,9,5,106,45,61,59,39,20,72,46
04-08-2020 15:00:00,14,8,6,121,55,66,66,34,32,77,43
04-08-2020 16:00:00,19,8,11,174,88,86,77,42,35,133,51
04-08-2020 17:00:00,22,13,9,263,155,108,105,43,62,176,56
04-08-2020 18:00:00,29,16,13,233,128,105,122,77,45,170,72
04-08-2020 19:00:00,8,5,3,168,87,81,89,57,32,80,47
04-08-2020 20:00:00,15,7,8,114,64,50,76,34,42,58,41
04-08-2020 21:00:00,12,6,6,107,64,43,51,27,24,46,24
04-08-2020 22:00:00,3,2,1,54,37,17,25,9,16,45,21
04-08-2020 23:00:00,1,0,1,31,23,8,12,1,11,22,9
05-08-2020 00:00:00,3,1,2,13,10,3,4,3,1,12,7
05-08-2020 01:00:00,1,0,1,10,6,4,2,2,0,10,4
05-08-2020 02:00:00,2,0,2,5,3,2,0,0,0,7,3
05-08-2020 03:00:00,0,0,0,6,3,3,0,0,0,0,1
05-08-2020 04:00:00,0,0,0,6,3,3,2,2,0,2,5
05-08-2020 05:00:00,0,0,0,25,5,20,12,10,2,5,18
05-08-2020 06:00:00,10,8,2,102,18,84,77,67,10,16,72
05-08-2020 07:00:00,9,8,1,180,45,135,99,82,17,26,116
05-08-2020 08:00:00,13,10,3,267,68,199,115,103,12,37,151
05-08-2020 09:00:00,7,5,2,143,33,110,52,47,5,21,82
05-08-2020 10:00:00,7,6,1,77,23,54,29,18,11,29,49
05-08-2020 11:00:00,7,6,1,84,28,56,49,35,14,24,36
05-08-2020 12:00:00,15,10,5,120,44,76,50,35,15,44,40
05-08-2020 13:00:00,10,7,3,101,40,61,48,29,19,51,33
05-08-2020 14:00:00,11,7,4,108,50,58,42,28,14,48,42
05-08-2020 15:00:00,9,5,4,117,56,61,69,41,28,85,48
05-08-2020 16:00:00,13,7,6,131,70,61,93,47,46,120,46
05-08-2020 17:00:00,21,13,8,284,160,124,104,47,57,184,65
05-08-2020 18:00:00,13,6,7,219,122,97,137,77,60,152,63
05-08-2020 19:00:00,12,8,4,168,80,88,95,50,45,85,44
05-08-2020 20:00:00,15,6,9,127,67,60,73,34,39,66,44
05-08-2020 21:00:00,7,2,5,106,59,47,53,27,26,71,35
05-08-2020 22:00:00,6,6,0,59,44,15,34,14,20,32,22
05-08-2020 23:00:00,3,1,2,47,34,13,15,5,10,37,15
06-08-2020 00:00:00,4,2,2,13,8,5,6,3,3,18,6
06-08-2020 01:00:00,1,1,0,6,5,1,2,2,0,3,0
06-08-2020 02:00:00,0,0,0,9,6,3,0,0,0,4,1
06-08-2020 03:00:00,1,0,1,5,2,3,2,1,1,0,0
06-08-2020 04:00:00,0,0,0,10,1,9,2,2,0,0,7
06-08-2020 05:00:00,1,1,0,26,5,21,12,11,1,4,23
06-08-2020 06:00:00,5,4,1,112,18,94,72,65,7,13,68
06-08-2020 07:00:00,8,7,1,195,54,141,104,85,19,32,123
06-08-2020 08:00:00,16,13,3,271,61,210,117,105,12,35,169
06-08-2020 09:00:00,14,11,3,147,30,117,70,62,8,27,98
06-08-2020 10:00:00,9,7,2,116,49,67,49,36,13,33,63
06-08-2020 11:00:00,6,3,3,112,26,86,64,47,17,39,55
06-08-2020 12:00:00,12,6,6,125,40,85,50,30,20,67,68
06-08-2020 13:00:00,14,6,8,125,48,77,77,43,34,70,68
06-08-2020 14:00:00,24,18,6,130,59,71,77,45,32,78,65
06-08-2020 15:00:00,16,8,8,133,74,59,66,36,30,97,71
06-08-2020 16:00:00,9,7,2,172,91,81,83,44,39,170,56
06-08-2020 17:00:00,22,13,9,292,169,123,131,77,54,166,83
06-08-2020 18:00:00,28,14,14,246,143,103,128,73,55,163,81
06-08-2020 19:00:00,25,12,13,200,94,106,97,59,38,119,70
06-08-2020 20:00:00,21,11,10,140,77,63,91,56,35,104,57
06-08-2020 21:00:00,12,3,9,104,70,34,42,23,19,55,48
06-08-2020 22:00:00,6,4,2,80,61,19,42,21,21,54,30
06-08-2020 23:00:00,7,1,6,44,31,13,14,4,10,41,16
07-08-2020 00:00:00,2,0,2,20,11,9,9,3,6,35,8
07-08-2020 01:00:00,0,0,0,12,12,0,3,3,0,6,3
07-08-2020 02:00:00,0,0,0,5,3,2,0,0,0,4,2
07-08-2020 03:00:00,2,2,0,4,2,2,0,0,0,1,1
07-08-2020 04:00:00,0,0,0,6,1,5,4,3,1,2,5
07-08-2020 05:00:00,1,1,0,24,5,19,10,9,1,6,19
07-08-2020 06:00:00,6,6,0,105,16,89,81,69,12,17,67
07-08-2020 07:00:00,5,3,2,169,47,122,108,91,17,26,125
07-08-2020 08:00:00,22,20,2,213,46,167,105,95,10,39,135
07-08-2020 09:00:00,10,4,6,152,37,115,55,48,7,22,77
07-08-2020 10:00:00,13,10,3,92,29,63,47,32,15,32,65
07-08-2020 11:00:00,10,6,4,95,25,70,69,54,15,30,49
07-08-2020 12:00:00,19,11,8,133,44,89,70,46,24,54,83
07-08-2020 13:00:00,15,8,7,131,60,71,76,45,31,88,66
07-08-2020 14:00:00,20,12,8,146,57,89,76,47,29,81,61
07-08-2020 15:00:00,11,7,4,170,78,92,86,39,47,99,60
07-08-2020 16:00:00,20,12,8,192,92,100,119,61,58,137,78
07-08-2020 17:00:00,25,18,7,286,158,128,134,56,78,178,78
07-08-2020 18:00:00,18,10,8,239,132,107,87,56,31,147,58
07-08-2020 19:00:00,17,6,11,208,94,114,91,60,31,100,63
07-08-2020 20:00:00,14,10,4,158,70,88,75,37,38,65,46
07-08-2020 21:00:00,7,4,3,115,68,47,37,17,20,52,23
07-08-2020 22:00:00,9,6,3,83,56,27,30,14,16,50,29
07-08-2020 23:00:00,2,2,0,73,49,24,27,9,18,41,22
08-08-2020 00:00:00,2,0,2,48,34,14,14,7,7,25,9
08-08-2020 01:00:00,1,1,0,19,12,7,7,2,5,8,11
08-08-2020 02:00:00,2,1,1,9,1,8,2,2,0,8,7
08-08-2020 03:00:00,1,1,0,12,8,4,0,0,0,13,3
08-08-2020 04:00:00,0,0,0,11,5,6,1,1,0,1,5
08-08-2020 05:00:00,1,1,0,14,5,9,5,3,2,10,10
08-08-2020 06:00:00,0,0,0,36,9,27,23,22,1,8,19
08-08-2020 07:00:00,3,3,0,68,15,53,49,39,10,28,45
08-08-2020 08:00:00,7,6,1,67,20,47,45,39,6,21,42
08-08-2020 09:00:00,6,4,2,97,36,61,54,37,17,44,66
08-08-2020 10:00:00,19,13,6,138,47,91,83,57,26,58,58
08-08-2020 11:00:00,18,13,5,138,45,93,91,50,41,93,55
08-08-2020 12:00:00,28,17,11,185,69,116,121,79,42,130,61
08-08-2020 13:00:00,34,20,14,178,73,105,137,75,62,115,75
08-08-2020 14:00:00,30,14,16,187,72,115,127,68,59,133,99
08-08-2020 15:00:00,23,13,10,166,60,106,124,73,51,118,75
08-08-2020 16:00:00,8,3,5,184,84,100,92,59,33,118,94
08-08-2020 17:00:00,12,6,6,167,78,89,71,37,34,110,107
08-08-2020 18:00:00,24,11,13,209,107,102,90,53,37,112,103
08-08-2020 19:00:00,20,8,12,164,88,76,83,40,43,92,106
08-08-2020 20:00:00,13,5,8,138,86,52,45,27,18,62,89
08-08-2020 21:00:00,7,1,6,107,59,48,37,17,20,61,57
08-08-2020 22:00:00,13,11,2,64,42,22,38,17,21,56,43
08-08-2020 23:00:00,1,0,1,49,34,15,21,14,7,51,21
09-08-2020 00:00:00,4,1,3,43,27,16,18,6,12,27,13
09-08-2020 01:00:00,0,0,0,22,15,7,5,3,2,6,10
09-08-2020 02:00:00,0,0,0,11,9,2,1,1,0,17,3
09-08-2020 03:00:00,0,0,0,5,4,1,0,0,0,6,3
09-08-2020 04:00:00,2,2,0,9,4,5,1,1,0,4,3
09-08-2020 05:00:00,0,0,0,13,3,10,3,2,1,2,5
09-08-2020 06:00:00,3,3,0,19,5,14,19,14,5,13,14
09-08-2020 07:00:00,1,1,0,36,12,24,25,13,12,19,29
09-08-2020 08:00:00,4,3,1,48,13,35,32,27,5,27,39
09-08-2020 09:00:00,6,3,3,94,27,67,50,38,12,23,40
09-08-2020 10:00:00,7,4,3,96,29,67,62,40,22,28,52
09-08-2020 11:00:00,14,7,7,96,35,61,93,50,43,69,38
09-08-2020 12:00:00,19,14,5,134,41,93,108,59,49,66,49
09-08-2020 13:00:00,20,12,8,135,65,70,80,49,31,108,49
09-08-2020 14:00:00,17,11,6,133,53,80,98,54,44,76,56
09-08-2020 15:00:00,21,11,10,135,59,76,112,73,39,75,50
09-08-2020 16:00:00,12,4,8,136,55,81,96,55,41,69,83
09-08-2020 17:00:00,16,5,11,141,83,58,58,23,35,76,49
09-08-2020 18:00:00,10,4,6,135,73,62,63,31,32,97,64
09-08-2020 19:00:00,12,9,3,121,67,54,64,39,25,62,49
09-08-2020 20:00:00,11,3,8,127,71,56,58,29,29,33,50
09-08-2020 21:00:00,7,6,1,87,52,35,38,20,18,44,44
09-08-2020 22:00:00,1,1,0,57,39,18,38,11,27,38,27
09-08-2020 23:00:00,1,0,1,33,23,10,14,6,8,23,10
10-08-2020 00:00:00,0,0,0,10,6,4,4,1,3,7,1
10-08-2020 01:00:00,1,0,1,9,7,2,3,3,0,6,1
10-08-2020 02:00:00,1,1,0,3,2,1,0,0,0,0,1
10-08-2020 03:00:00,1,0,1,7,4,3,0,0,0,1,0
10-08-2020 04:00:00,0,0,0,8,4,4,2,2,0,2,7
10-08-2020 05:00:00,1,1,0,23,0,23,10,10,0,5,20
10-08-2020 06:00:00,5,4,1,94,15,79,81,71,10,14,70
10-08-2020 07:00:00,13,11,2,167,38,129,104,90,14,22,125
10-08-2020 08:00:00,9,9,0,260,54,206,128,116,12,41,156
10-08-2020 09:00:00,13,11,2,126,23,103,66,57,9,24,85
10-08-2020 10:00:00,8,7,1,70,20,50,37,30,7,32,49
10-08-2020 11:00:00,10,5,5,83,30,53,54,46,8,32,42
10-08-2020 12:00:00,12,6,6,110,41,69,65,38,27,56,45
10-08-2020 13:00:00,14,10,4,109,50,59,60,33,27,72,52
10-08-2020 14:00:00,10,2,8,90,50,40,62,27,35,58,40
10-08-2020 15:00:00,5,3,2,84,44,40,54,24,30,68,27
10-08-2020 16:00:00,12,7,5,147,92,55,75,40,35,111,30
10-08-2020 17:00:00,17,7,10,246,145,101,102,38,64,168,41
10-08-2020 18:00:00,16,3,13,214,127,87,97,56,41,182,55
10-08-2020 19:00:00,12,7,5,135,76,59,72,42,30,80,34
10-08-2020 20:00:00,13,5,8,104,55,49,50,24,26,59,57
10-08-2020 21:00:00,9,6,3,69,48,21,42,20,22,37,27
10-08-2020 22:00:00,4,4,0,36,25,11,23,11,12,36,19
10-08-2020 23:00:00,1,1,0,27,22,5,5,3,2,13,12
11-08-2020 00:00:00,1,1,0,12,8,4,5,2,3,12,5
11-08-2020 01:00:00,1,0,1,5,4,1,2,2,0,0,3
11-08-2020 02:00:00,0,0,0,3,1,2,2,2,0,3,2
11-08-2020 03:00:00,0,0,0,3,1,2,1,1,0,0,0
11-08-2020 04:00:00,1,0,1,10,6,4,0,0,0,1,3
11-08-2020 05:00:00,3,2,1,20,2,18,8,8,0,6,19
11-08-2020 06:00:00,3,2,1,99,14,85,88,75,13,16,72
11-08-2020 07:00:00,17,15,2,199,51,148,117,98,19,29,118
11-08-2020 08:00:00,20,12,8,304,61,243,140,132,8,48,180
11-08-2020 09:00:00,11,9,2,152,30,122,69,62,7,23,92
11-08-2020 10:00:00,7,6,1,67,20,47,49,38,11,31,72
11-08-2020 11:00:00,7,2,5,72,33,39,42,26,16,37,50
11-08-2020 12:00:00,11,7,4,126,46,80,69,43,26,75,36
11-08-2020 13:00:00,14,9,5,134,61,73,69,44,25,72,57
11-08-2020 14:00:00,25,12,13,107,47,60,77,48,29,67,50
11-08-2020 15:00:00,18,7,11,134,60,74,88,41,47,80,61
11-08-2020 16:00:00,15,7,8,182,96,86,95,52,43,154,74
11-08-2020 17:00:00,22,9,13,278,177,101,136,66,70,199,72
11-08-2020 18:00:00,18,9,9,273,134,139,149,73,76,243,62
11-08-2020 19:00:00,14,7,7,165,92,73,90,48,42,131,64
11-08-2020 20:00:00,10,3,7,127,68,59,61,29,32,67,56
11-08-2020 21:00:00,8,2,6,114,66,48,47,17,30,53,47
11-08-2020 22:00:00,4,3,1,67,40,27,36,15,21,51,18
11-08-2020 23:00:00,5,1,4,40,28,12,7,2,5,25,12
12-08-2020 00:00:00,2,0,2,23,15,8,6,3,3,10,5
12-08-2020 01:00:00,3,2,1,11,9,2,3,3,0,6,1
12-08-2020 02:00:00,0,0,0,2,0,2,0,0,0,2,1
12-08-2020 03:00:00,1,0,1,4,2,2,1,0,1,4,1
12-08-2020 04:00:00,0,0,0,9,2,7,4,3,1,1,2
12-08-2020 05:00:00,0,0,0,23,5,18,14,10,4,8,24
12-08-2020 06:00:00,5,5,0,101,12,89,86,75,11,15,75
12-08-2020 07:00:00,7,5,2,194,55,139,125,105,20,35,140
12-08-2020 08:00:00,20,18,2,277,56,221,156,145,11,37,172
12-08-2020 09:00:00,12,8,4,174,42,132,90,77,13,33,110
12-08-2020 10:00:00,11,8,3,95,27,68,43,34,9,35,48
12-08-2020 11:00:00,13,9,4,103,31,72,61,41,20,44,45
12-08-2020 12:00:00,15,6,9,123,43,80,70,37,33,69,65
12-08-2020 13:00:00,25,21,4,128,62,66,95,60,35,84,50
12-08-2020 14:00:00,14,9,5,131,55,76,72,41,31,95,52
12-08-2020 15:00:00,15,6,9,144,62,82,97,47,50,108,50
12-08-2020 16:00:00,27,16,11,173,107,66,100,44,56,159,63
12-08-2020 17:00:00,32,11,21,346,194,152,140,63,77,233,70
12-08-2020 18:00:00,22,11,11,264,145,119,134,82,52,210,91
12-08-2020 19:00:00,19,8,11,219,111,108,77,41,36,130,65
12-08-2020 20:00:00,14,4,10,167,95,72,82,36,46,77,54
12-08-2020 21:00:00,20,8,12,128,74,54,64,39,25,66,54
12-08-2020 22:00:00,11,4,7,70,46,24,37,11,26,50,14
12-08-2020 23:00:00,4,2,2,50,34,16,22,8,14,43,17
13-08-2020 00:00:00,5,1,4,21,12,9,11,8,3,16,6
13-08-2020 01:00:00,0,0,0,14,9,5,3,2,1,5,2
13-08-2020 02:00:00,0,0,0,3,2,1,2,1,1,5,1
13-08-2020 03:00:00,0,0,0,7,4,3,1,0,1,5,1
13-08-2020 04:00:00,0,0,0,8,1,7,3,3,0,2,5
13-08-2020 05:00:00,1,1,0,24,2,22,13,12,1,8,13
13-08-2020 06:00:00,7,6,1,105,18,87,77,66,11,18,74
13-08-2020 07:00:00,8,5,3,191,48,143,117,98,19,37,116
13-08-2020 08:00:00,18,15,3,268,55,213,145,131,14,46,189
13-08-2020 09:00:00,16,11,5,141,31,110,83,74,9,28,87
13-08-2020 10:00:00,7,7,0,93,27,66,32,24,8,43,57
13-08-2020 11:00:00,14,8,6,95,32,63,74,54,20,31,53
13-08-2020 12:00:00,9,7,2,126,50,76,69,49,20,53,47
13-08-2020 13:00:00,7,4,3,139,59,80,65,49,16,81,78
13-08-2020 14:00:00,11,5,6,125,44,81,71,43,28,70,69
13-08-2020 15:00:00,10,7,3,137,63,74,84,43,41,95,65
13-08-2020 16:00:00,20,10,10,194,95,99,107,53,54,144,90
13-08-2020 17:00:00,30,12,18,312,186,126,158,71,87,236,89
13-08-2020 18:00:00,37,14,23,298,148,150,145,83,62,221,96
13-08-2020 19:00:00,25,11,14,243,125,118,142,64,78,123,70
13-08-2020 20:00:00,15,3,12,180,108,72,96,44,52,88,83
13-08-2020 21:00:00,10,7,3,132,71,61,77,36,41,61,42
13-08-2020 22:00:00,6,3,3,80,60,20,38,19,19,52,33
13-08-2020 23:00:00,1,1,0,61,39,22,28,11,17,57,15
14-08-2020 00:00:00,3,2,1,34,21,13,8,3,5,18,2
14-08-2020 01:00:00,0,0,0,16,9,7,5,4,1,11,3
14-08-2020 02:00:00,0,0,0,13,10,3,0,0,0,2,2
14-08-2020 03:00:00,0,0,0,7,2,5,0,0,0,4,1
14-08-2020 04:00:00,0,0,0,10,5,5,3,3,0,2,2
14-08-2020 05:00:00,3,3,0,26,5,21,13,13,0,5,23
14-08-2020 06:00:00,6,5,1,89,13,76,72,63,9,21,61
14-08-2020 07:00:00,7,6,1,185,44,141,106,88,18,38,110
14-08-2020 08:00:00,17,14,3,242,57,185,140,125,15,35,133
14-08-2020 09:00:00,13,8,5,146,40,106,54,45,9,31,98
14-08-2020 10:00:00,9,5,4,89,29,60,42,28,14,24,52
14-08-2020 11:00:00,8,5,3,98,38,60,52,41,11,43,54
14-08-2020 12:00:00,21,7,14,123,47,76,71,48,23,62,65
14-08-2020 13:00:00,11,4,7,173,73,100,84,47,37,76,60
14-08-2020 14:00:00,11,4,7,145,57,88,72,39,33,76,55
14-08-2020 15:00:00,15,10,5,172,89,83,77,40,37,90,43
14-08-2020 16:00:00,18,8,10,197,98,99,105,49,56,125,61
14-08-2020 17:00:00,18,10,8,249,143,106,134,61,73,166,73
14-08-2020 18:00:00,10,4,6,255,126,129,96,54,42,161,73
14-08-2020 19:00:00,13,4,9,238,116,122,91,56,35,108,83
14-08-2020 20:00:00,18,10,8,153,64,89,93,53,40,72,73
14-08-2020 21:00:00,8,5,3,113,62,51,50,26,24,73,36
14-08-2020 22:00:00,5,2,3,86,58,28,35,17,18,59,38
14-08-2020 23:00:00,3,2,1,83,53,30,26,8,18,53,10
15-08-2020 00:00:00,2,1,1,29,22,7,18,6,12,22,14
15-08-2020 01:00:00,1,0,1,25,20,5,4,3,1,17,5
15-08-2020 02:00:00,0,0,0,10,5,5,7,5,2,9,4
15-08-2020 03:00:00,0,0,0,6,4,2,3,1,2,8,1
15-08-2020 04:00:00,0,0,0,12,6,6,2,1,1,2,5
15-08-2020 05:00:00,1,1,0,16,6,10,7,7,0,4,10
15-08-2020 06:00:00,0,0,0,47,7,40,25,23,2,8,24
15-08-2020 07:00:00,2,2,0,52,12,40,40,32,8,20,39
15-08-2020 08:00:00,10,10,0,76,23,53,38,34,4,32,52
15-08-2020 09:00:00,7,3,4,84,32,52,57,47,10,27,53
15-08-2020 10:00:00,11,9,2,128,37,91,66,47,19,40,56
15-08-2020 11:00:00,12,8,4,132,51,81,50,28,22,76,43
15-08-2020 12:00:00,21,9,12,160,66,94,84,50,34,103,63
15-08-2020 13:00:00,22,15,7,168,67,101,95,65,30,104,70
15-08-2020 14:00:00,22,14,8,154,49,105,82,48,34,100,89
15-08-2020 15:00:00,19,8,11,157,73,84,87,45,42,97,83
15-08-2020 16:00:00,14,5,9,159,72,87,117,76,41,101,102
15-08-2020 17:00:00,18,9,9,188,83,105,87,56,31,107,82
15-08-2020 18:00:00,27,17,10,172,96,76,97,52,45,91,78
15-08-2020 19:00:00,10,3,7,137,66,71,61,37,24,75,61
15-08-2020 20:00:00,14,9,5,134,67,67,42,24,18,58,62
15-08-2020 21:00:00,4,3,1,93,61,32,35,18,17,44,21
15-08-2020 22:00:00,0,0,0,58,31,27,29,12,17,46,24
15-08-2020 23:00:00,4,2,2,68,45,23,22,8,14,51,13
16-08-2020 00:00:00,0,0,0,43,27,16,18,7,11,27,10
16-08-2020 01:00:00,2,2,0,23,22,1,9,4,5,22,7
16-08-2020 02:00:00,2,1,1,12,4,8,2,2,0,4,3
16-08-2020 03:00:00,0,0,0,8,2,6,1,1,0,3,1
16-08-2020 04:00:00,0,0,0,5,2,3,1,1,0,5,3
16-08-2020 05:00:00,0,0,0,14,5,9,1,1,0,1,5
16-08-2020 06:00:00,0,0,0,25,5,20,20,16,4,8,13
16-08-2020 07:00:00,1,1,0,29,12,17,28,24,4,10,23
16-08-2020 08:00:00,2,1,1,50,7,43,21,19,2,18,31
16-08-2020 09:00:00,7,6,1,60,21,39,41,26,15,21,36
16-08-2020 10:00:00,13,7,6,71,20,51,42,27,15,31,31
16-08-2020 11:00:00,8,8,0,85,28,57,55,43,12,43,45
16-08-2020 12:00:00,12,5,7,100,30,70,67,39,28,63,41
16-08-2020 13:00:00,13,7,6,98,35,63,81,50,31,42,50
16-08-2020 14:00:00,16,9,7,105,47,58,79,45,34,54,62
16-08-2020 15:00:00,3,2,1,99,46,53,44,22,22,59,32
16-08-2020 16:00:00,5,2,3,93,42,51,55,32,23,63,57
16-08-2020 17:00:00,11,10,1,110,56,54,68,37,31,56,40
16-08-2020 18:00:00,10,7,3,111,48,63,55,35,20,71,52
16-08-2020 19:00:00,15,10,5,119,69,50,44,29,15,58,44
16-08-2020 20:00:00,5,3,2,80,39,41,32,17,15,38,30
16-08-2020 21:00:00,9,5,4,72,43,29,40,22,18,44,23
16-08-2020 22:00:00,4,4,0,54,39,15,26,11,15,30,13
16-08-2020 23:00:00,2,2,0,25,16,9,15,5,10,27,8
17-08-2020 00:00:00,0,0,0,12,6,6,4,2,2,11,4
17-08-2020 01:00:00,0,0,0,4,2,2,2,0,2,7,1
17-08-2020 02:00:00,0,0,0,0,0,0,0,0,0,1,2
17-08-2020 03:00:00,0,0,0,1,1,0,0,0,0,0,0
17-08-2020 04:00:00,1,1,0,6,3,3,2,2,0,1,4
17-08-2020 05:00:00,2,2,0,23,2,21,8,8,0,3,10
17-08-2020 06:00:00,6,4,2,71,11,60,71,67,4,12,55
17-08-2020 07:00:00,12,9,3,135,24,111,104,84,20,19,84
17-08-2020 08:00:00,7,7,0,200,46,154,107,98,9,35,110
17-08-2020 09:00:00,6,5,1,128,30,98,56,48,8,23,67
17-08-2020 10:00:00,3,1,2,60,13,47,25,21,4,18,42
17-08-2020 11:00:00,2,2,0,72,31,41,37,30,7,22,29
17-08-2020 12:00:00,3,1,2,80,31,49,38,29,9,43,41
17-08-2020 13:00:00,5,4,1,106,44,62,48,33,15,49,43
17-08-2020 14:00:00,5,3,2,85,52,33,38,23,15,49,36
17-08-2020 15:00:00,12,7,5,66,41,25,46,24,22,55,31
17-08-2020 16:00:00,11,3,8,112,69,43,57,25,32,81,35
17-08-2020 17:00:00,16,3,13,177,101,76,84,35,49,126,58
17-08-2020 18:00:00,11,3,8,155,95,60,64,30,34,132,34
17-08-2020 19:00:00,5,4,1,102,51,51,43,23,20,78,40
17-08-2020 20:00:00,5,1,4,71,37,34,31,13,18,51,26
17-08-2020 21:00:00,10,6,4,54,30,24,20,5,15,36,18
17-08-2020 22:00:00,4,4,0,32,23,9,12,5,7,29,12
17-08-2020 23:00:00,1,1,0,19,14,5,10,4,6,23,7
18-08-2020 00:00:00,1,1,0,9,6,3,2,2,0,13,7
18-08-2020 01:00:00,0,0,0,5,3,2,1,1,0,2,4
18-08-2020 02:00:00,0,0,0,2,0,2,0,0,0,2,3
18-08-2020 03:00:00,0,0,0,4,2,2,0,0,0,1,1
18-08-2020 04:00:00,0,0,0,7,3,4,3,3,0,1,4
18-08-2020 05:00:00,2,2,0,23,4,19,10,8,2,5,13
18-08-2020 06:00:00,8,8,0,69,9,60,62,55,7,22,49
18-08-2020 07:00:00,10,6,4,120,30,90,78,64,14,11,81
18-08-2020 08:00:00,8,8,0,189,46,143,80,69,11,20,106
18-08-2020 09:00:00,5,3,2,103,20,83,49,45,4,12,44
18-08-2020 10:00:00,1,1,0,62,18,44,14,12,2,15,38
18-08-2020 11:00:00,7,5,2,90,24,66,44,36,8,14,36
18-08-2020 12:00:00,14,9,5,118,42,76,43,26,17,45,38
18-08-2020 13:00:00,11,8,3,124,51,73,58,40,18,47,39
18-08-2020 14:00:00,13,9,4,131,46,85,66,38,28,67,53
18-08-2020 15:00:00,8,4,4,103,41,62,70,39,31,75,57
18-08-2020 16:00:00,10,4,6,154,86,68,80,42,38,109,74
18-08-2020 17:00:00,12,5,7,236,122,114,113,57,56,159,50
18-08-2020 18:00:00,17,8,9,232,122,110,98,49,49,111,48
18-08-2020 19:00:00,18,12,6,180,80,100,79,44,35,110,49
18-08-2020 20:00:00,25,16,9,125,55,70,55,31,24,70,52
18-08-2020 21:00:00,11,6,5,100,66,34,37,16,21,45,46
18-08-2020 22:00:00,6,4,2,57,39,18,14,12,2,32,19
18-08-2020 23:00:00,3,1,2,32,22,10,6,3,3,30,5
19-08-2020 00:00:00,1,0,1,17,11,6,4,4,0,9,9
19-08-2020 01:00:00,0,0,0,8,4,4,2,2,0,2,1
19-08-2020 02:00:00,0,0,0,3,1,2,1,1,0,5,3
19-08-2020 03:00:00,0,0,0,5,2,3,0,0,0,0,1
19-08-2020 04:00:00,2,1,1,7,1,6,3,2,1,1,4
19-08-2020 05:00:00,2,2,0,21,2,19,12,11,1,6,16
19-08-2020 06:00:00,8,7,1,102,19,83,73,66,7,16,66
19-08-2020 07:00:00,15,11,4,162,40,122,105,94,11,24,109
19-08-2020 08:00:00,18,16,2,244,60,184,130,118,12,33,159
19-08-2020 09:00:00,15,9,6,146,41,105,70,58,12,28,80
19-08-2020 10:00:00,5,3,2,79,23,56,35,23,12,18,56
19-08-2020 11:00:00,8,4,4,76,26,50,38,27,11,26,35
19-08-2020 12:00:00,3,2,1,103,30,73,39,23,16,44,34
19-08-2020 13:00:00,5,3,2,81,40,41,34,21,13,45,27
19-08-2020 14:00:00,5,3,2,86,45,41,36,19,17,41,32
19-08-2020 15:00:00,2,1,1,85,49,36,29,10,19,41,28
19-08-2020 16:00:00,7,3,4,105,65,40,48,22,26,90,22
19-08-2020 17:00:00,11,5,6,195,119,76,78,28,50,143,39
19-08-2020 18:00:00,10,2,8,175,107,68,72,36,36,137,32
19-08-2020 19:00:00,6,2,4,126,60,66,58,32,26,69,31
19-08-2020 20:00:00,7,1,6,95,49,46,33,17,16,62,18
19-08-2020 21:00:00,8,7,1,68,43,25,32,19,13,32,30
19-08-2020 22:00:00,6,1,5,44,33,11,12,3,9,26,11
19-08-2020 23:00:00,1,0,1,26,17,9,9,5,4,14,2
20-08-2020 00:00:00,0,0,0,9,5,4,2,1,1,8,2
20-08-2020 01:00:00,0,0,0,3,3,0,0,0,0,1,1
20-08-2020 02:00:00,0,0,0,2,0,2,0,0,0,2,1
20-08-2020 03:00:00,0,0,0,1,0,1,1,1,0,0,0
20-08-2020 04:00:00,0,0,0,8,2,6,1,1,0,1,6
20-08-2020 05:00:00,1,1,0,19,2,17,7,5,2,4,10
20-08-2020 06:00:00,9,8,1,89,16,73,67,62,5,11,57
20-08-2020 07:00:00,8,6,2,123,30,93,86,75,11,25,100
20-08-2020 08:00:00,14,11,3,240,68,172,107,96,11,29,146
20-08-2020 09:00:00,11,9,2,117,36,81,62,50,12,18,74
20-08-2020 10:00:00,6,3,3,86,23,63,23,18,5,26,40
20-08-2020 11:00:00,5,4,1,91,26,65,36,26,10,28,32
20-08-2020 12:00:00,6,3,3,99,39,60,53,36,17,38,31
20-08-2020 13:00:00,8,6,2,96,41,55,41,28,13,38,42
20-08-2020 14:00:00,10,4,6,95,44,51,45,22,23,47,42
20-08-2020 15:00:00,15,10,5,113,54,59,65,32,33,69,43
20-08-2020 16:00:00,9,4,5,166,87,79,78,44,34,90,46
20-08-2020 17:00:00,19,8,11,225,130,95,101,49,52,145,56
20-08-2020 18:00:00,9,2,7,208,109,99,73,33,40,129,46
20-08-2020 19:00:00,11,6,5,142,80,62,59,41,18,85,54
20-08-2020 20:00:00,4,1,3,113,63,50,38,25,13,62,35
20-08-2020 21:00:00,10,6,4,70,44,26,29,12,17,44,27
20-08-2020 22:00:00,2,1,1,50,31,19,29,7,22,26,9
20-08-2020 23:00:00,0,0,0,28,19,9,14,2,12,29,7
21-08-2020 00:00:00,0,0,0,17,11,6,6,3,3,6,3
21-08-2020 01:00:00,2,2,0,7,6,1,0,0,0,5,0
21-08-2020 02:00:00,0,0,0,2,1,1,3,1,2,2,1
21-08-2020 03:00:00,0,0,0,6,2,4,0,0,0,3,0
21-08-2020 04:00:00,0,0,0,7,2,5,4,4,0,2,5
21-08-2020 05:00:00,2,1,1,17,5,12,8,6,2,6,10
21-08-2020 06:00:00,7,5,2,95,17,78,69,65,4,16,48
21-08-2020 07:00:00,6,6,0,127,33,94,97,84,13,19,85
21-08-2020 08:00:00,14,12,2,207,50,157,104,91,13,35,127
21-08-2020 09:00:00,18,15,3,120,31,89,63,55,8,29,81
21-08-2020 10:00:00,9,4,5,86,13,73,28,18,10,31,54
21-08-2020 11:00:00,12,8,4,97,34,63,48,35,13,24,21
21-08-2020 12:00:00,10,4,6,117,38,79,54,34,20,51,38
21-08-2020 13:00:00,10,5,5,120,57,63,72,41,31,44,43
21-08-2020 14:00:00,19,8,11,117,51,66,57,38,19,47,47
21-08-2020 15:00:00,9,9,0,107,58,49,60,35,25,65,37
21-08-2020 16:00:00,16,5,11,177,84,93,68,27,41,75,49
21-08-2020 17:00:00,16,6,10,208,111,97,96,54,42,133,55
21-08-2020 18:00:00,13,6,7,191,101,90,85,47,38,130,62
21-08-2020 19:00:00,15,8,7,184,80,104,78,44,34,95,57
21-08-2020 20:00:00,17,8,9,149,74,75,58,32,26,78,49
21-08-2020 21:00:00,6,3,3,102,55,47,42,24,18,59,33
21-08-2020 22:00:00,3,2,1,51,24,27,32,13,19,49,21
21-08-2020 23:00:00,2,1,1,59,40,19,39,20,19,49,16
22-08-2020 00:00:00,0,0,0,33,19,14,11,7,4,23,11
22-08-2020 01:00:00,0,0,0,16,7,9,1,0,1,9,4
22-08-2020 02:00:00,0,0,0,11,9,2,1,0,1,5,2
22-08-2020 03:00:00,1,1,0,7,5,2,0,0,0,2,3
22-08-2020 04:00:00,0,0,0,10,4,6,1,1,0,3,3
22-08-2020 05:00:00,0,0,0,7,4,3,0,0,0,1,7
22-08-2020 06:00:00,1,1,0,45,8,37,16,16,0,13,19
22-08-2020 07:00:00,6,5,1,51,19,32,40,33,7,17,45
22-08-2020 08:00:00,5,4,1,74,31,43,30,28,2,22,35
22-08-2020 09:00:00,15,9,6,80,32,48,39,32,7,29,36
22-08-2020 10:00:00,15,4,11,108,39,69,57,37,20,21,62
22-08-2020 11:00:00,15,13,2,113,37,76,74,55,19,48,39
22-08-2020 12:00:00,15,9,6,128,52,76,64,39,25,56,37
22-08-2020 13:00:00,9,4,5,131,51,80,77,41,36,45,61
22-08-2020 14:00:00,12,8,4,90,35,55,55,33,22,72,57
22-08-2020 15:00:00,7,5,2,106,45,61,53,29,24,63,63
22-08-2020 16:00:00,6,2,4,96,44,52,59,30,29,74,62
22-08-2020 17:00:00,10,7,3,110,55,55,52,34,18,90,43
22-08-2020 18:00:00,6,2,4,96,49,47,57,41,16,67,49
22-08-2020 19:00:00,10,7,3,113,55,58,42,29,13,52,34
22-08-2020 20:00:00,10,5,5,97,37,60,42,28,14,41,32
22-08-2020 21:00:00,5,1,4,72,46,26,24,15,9,46,26
22-08-2020 22:00:00,6,3,3,65,46,19,25,14,11,35,22
22-08-2020 23:00:00,0,0,0,41,28,13,17,6,11,41,13
23-08-2020 00:00:00,4,3,1,29,20,9,8,6,2,25,4
23-08-2020 01:00:00,0,0,0,18,13,5,5,0,5,14,7
23-08-2020 02:00:00,1,1,0,14,11,3,3,0,3,7,2
23-08-2020 03:00:00,3,3,0,10,7,3,2,0,2,4,0
23-08-2020 04:00:00,1,1,0,3,2,1,2,2,0,6,2
23-08-2020 05:00:00,1,1,0,8,3,5,5,3,2,1,8
23-08-2020 06:00:00,2,2,0,17,4,13,18,15,3,8,12
23-08-2020 07:00:00,0,0,0,34,12,22,22,18,4,15,26
23-08-2020 08:00:00,2,2,0,48,17,31,46,35,11,24,38
23-08-2020 09:00:00,13,8,5,62,24,38,44,27,17,36,31
23-08-2020 10:00:00,6,5,1,79,21,58,39,30,9,33,48
23-08-2020 11:00:00,6,2,4,103,29,74,68,43,25,55,37
23-08-2020 12:00:00,17,8,9,100,41,59,70,42,28,64,71
23-08-2020 13:00:00,9,5,4,134,57,77,66,39,27,64,62
23-08-2020 14:00:00,14,6,8,120,54,66,91,52,39,78,62
23-08-2020 15:00:00,8,7,1,125,58,67,82,48,34,58,59
23-08-2020 16:00:00,7,3,4,100,48,52,71,50,21,62,68
23-08-2020 17:00:00,19,11,8,117,49,68,65,32,33,82,58
23-08-2020 18:00:00,11,6,5,149,89,60,53,28,25,76,64
23-08-2020 19:00:00,11,2,9,118,74,44,49,27,22,70,43
23-08-2020 20:00:00,10,2,8,82,49,33,39,21,18,34,27
23-08-2020 21:00:00,5,3,2,68,41,27,22,12,10,41,29
23-08-2020 22:00:00,1,1,0,42,21,21,34,17,17,34,9
23-08-2020 23:00:00,4,1,3,25,16,9,18,10,8,20,9
24-08-2020 00:00:00,2,0,2,12,7,5,3,1,2,11,2
24-08-2020 01:00:00,0,0,0,17,11,6,1,0,1,5,1
24-08-2020 02:00:00,1,0,1,7,5,2,0,0,0,1,3
24-08-2020 03:00:00,0,0,0,3,2,1,2,1,1,1,0
24-08-2020 04:00:00,0,0,0,8,5,3,1,1,0,1,5
24-08-2020 05:00:00,1,1,0,20,1,19,11,9,2,7,20
24-08-2020 06:00:00,7,7,0,99,22,77,71,66,5,14,73
24-08-2020 07:00:00,12,10,2,171,57,114,102,89,13,20,101
24-08-2020 08:00:00,13,10,3,266,70,196,122,110,12,42,184
24-08-2020 09:00:00,11,10,1,111,29,82,63,53,10,40,95
24-08-2020 10:00:00,5,4,1,82,27,55,42,36,6,27,50
24-08-2020 11:00:00,4,0,4,107,28,79,47,40,7,33,53
24-08-2020 12:00:00,6,3,3,130,49,81,76,53,23,54,72
24-08-2020 13:00:00,10,4,6,124,58,66,80,39,41,74,61
24-08-2020 14:00:00,10,3,7,128,62,66,66,31,35,75,43
24-08-2020 15:00:00,14,5,9,114,53,61,76,40,36,86,65
24-08-2020 16:00:00,9,4,5,170,98,72,92,54,38,154,58
24-08-2020 17:00:00,25,13,12,319,181,138,156,69,87,161,51
24-08-2020 18:00:00,18,7,11,223,117,106,108,52,56,194,55
24-08-2020 19:00:00,18,11,7,160,83,77,57,29,28,106,41
24-08-2020 20:00:00,10,4,6,150,86,64,53,22,31,67,21
24-08-2020 21:00:00,6,3,3,64,42,22,29,14,15,41,29
24-08-2020 22:00:00,6,4,2,48,34,14,18,10,8,29,14
24-08-2020 23:00:00,1,0,1,27,17,10,8,2,6,20,6
25-08-2020 00:00:00,0,0,0,8,7,1,4,3,1,7,5
25-08-2020 01:00:00,0,0,0,4,2,2,2,1,1,3,1
25-08-2020 02:00:00,1,0,1,2,2,0,0,0,0,1,0
25-08-2020 03:00:00,0,0,0,5,0,5,2,2,0,1,0
25-08-2020 04:00:00,0,0,0,5,1,4,1,1,0,1,2
25-08-2020 05:00:00,3,3,0,12,1,11,6,4,2,5,10
25-08-2020 06:00:00,8,7,1,74,18,56,64,57,7,11,32
25-08-2020 07:00:00,8,7,1,137,30,107,83,74,9,18,85
25-08-2020 08:00:00,14,11,3,224,50,174,112,101,11,27,151
25-08-2020 09:00:00,12,6,6,119,27,92,49,43,6,15,56
25-08-2020 10:00:00,6,6,0,62,16,46,19,15,4,16,38
25-08-2020 11:00:00,2,2,0,76,26,50,34,30,4,10,25
25-08-2020 12:00:00,6,4,2,89,35,54,39,30,9,36,35
25-08-2020 13:00:00,6,3,3,98,39,59,44,32,12,32,23
25-08-2020 14:00:00,7,4,3,78,38,40,41,20,21,42,12
25-08-2020 15:00:00,4,3,1,61,28,33,30,15,15,30,13
25-08-2020 16:00:00,9,2,7,98,54,44,59,31,28,77,17
25-08-2020 17:00:00,16,7,9,180,111,69,62,26,36,126,39
25-08-2020 18:00:00,10,4,6,148,84,64,71,30,41,100,17
25-08-2020 19:00:00,10,5,5,122,56,66,38,24,14,56,26
25-08-2020 20:00:00,10,3,7,67,32,35,31,18,13,31,33
25-08-2020 21:00:00,5,1,4,49,26,23,8,6,2,24,12
25-08-2020 22:00:00,3,1,2,42,31,11,17,12,5,19,5
25-08-2020 23:00:00,0,0,0,21,14,7,3,2,1,21,8
26-08-2020 00:00:00,1,1,0,9,7,2,3,3,0,4,5
26-08-2020 01:00:00,0,0,0,5,3,2,1,1,0,0,1
26-08-2020 02:00:00,0,0,0,3,0,3,0,0,0,1,1
26-08-2020 03:00:00,0,0,0,3,3,0,0,0,0,0,0
26-08-2020 04:00:00,0,0,0,10,5,5,0,0,0,1,5
26-08-2020 05:00:00,3,2,1,22,2,20,14,13,1,4,16
26-08-2020 06:00:00,6,5,1,96,18,78,72,63,9,24,54
26-08-2020 07:00:00,14,11,3,186,51,135,119,104,15,31,138
26-08-2020 08:00:00,12,10,2,259,58,201,122,106,16,30,189
26-08-2020 09:00:00,19,13,6,127,38,89,71,63,8,29,87
26-08-2020 10:00:00,5,2,3,97,27,70,38,29,9,25,53
26-08-2020 11:00:00,8,3,5,102,27,75,47,34,13,32,58
26-08-2020 12:00:00,15,7,8,147,56,91,61,40,21,53,60
26-08-2020 13:00:00,12,9,3,144,51,93,57,37,20,70,47
26-08-2020 14:00:00,8,4,4,145,59,86,51,24,27,90,51
26-08-2020 15:00:00,13,10,3,116,55,61,71,39,32,91,58
26-08-2020 16:00:00,11,5,6,219,111,108,119,52,67,141,68
26-08-2020 17:00:00,30,15,15,312,164,148,145,64,81,213,65
26-08-2020 18:00:00,26,9,17,314,168,146,143,81,62,185,77
26-08-2020 19:00:00,10,2,8,251,131,120,98,48,50,119,66
26-08-2020 20:00:00,8,4,4,168,91,77,83,41,42,83,66
26-08-2020 21:00:00,6,3,3,97,53,44,35,17,18,48,45
26-08-2020 22:00:00,7,2,5,61,45,16,17,9,8,34,21
26-08-2020 23:00:00,3,1,2,48,33,15,9,3,6,27,13
27-08-2020 00:00:00,0,0,0,22,16,6,4,4,0,16,8
27-08-2020 01:00:00,0,0,0,9,8,1,6,4,2,8,1
27-08-2020 02:00:00,0,0,0,7,6,1,0,0,0,6,0
27-08-2020 03:00:00,0,0,0,5,2,3,1,1,0,1,0
27-08-2020 04:00:00,0,0,0,11,2,9,1,1,0,1,5
27-08-2020 05:00:00,1,1,0,17,3,14,15,13,2,3,8
27-08-2020 06:00:00,8,7,1,99,26,73,89,76,13,18,67
27-08-2020 07:00:00,22,18,4,160,44,116,102,89,13,20,104
27-08-2020 08:00:00,9,8,1,246,58,188,117,105,12,36,175
27-08-2020 09:00:00,11,10,1,149,36,113,67,61,6,27,87
27-08-2020 10:00:00,8,5,3,82,30,52,31,25,6,18,46
27-08-2020 11:00:00,7,1,6,84,18,66,34,24,10,29,32
27-08-2020 12:00:00,8,5,3,114,45,69,44,27,17,36,36
27-08-2020 13:00:00,4,1,3,109,44,65,39,22,17,43,49
27-08-2020 14:00:00,7,3,4,98,43,55,45,25,20,47,37
27-08-2020 15:00:00,13,5,8,113,62,51,54,22,32,65,24
27-08-2020 16:00:00,14,5,9,123,65,58,65,34,31,92,45
27-08-2020 17:00:00,19,10,9,214,130,84,94,46,48,147,36
27-08-2020 18:00:00,15,8,7,210,117,93,76,38,38,122,28
27-08-2020 19:00:00,9,2,7,152,78,74,64,30,34,85,31
27-08-2020 20:00:00,8,2,6,120,66,54,50,31,19,65,46
27-08-2020 21:00:00,5,1,4,80,57,23,28,17,11,47,15
27-08-2020 22:00:00,6,4,2,42,28,14,20,9,11,18,10
27-08-2020 23:00:00,3,2,1,31,24,7,10,3,7,23,6
28-08-2020 00:00:00,2,0,2,13,7,6,1,1,0,8,3
28-08-2020 01:00:00,0,0,0,5,5,0,4,2,2,6,1
28-08-2020 02:00:00,1,0,1,4,2,2,0,0,0,3,2
28-08-2020 03:00:00,0,0,0,7,4,3,2,2,0,1,0
28-08-2020 04:00:00,0,0,0,8,2,6,1,1,0,1,2
28-08-2020 05:00:00,2,1,1,21,5,16,8,8,0,2,16
28-08-2020 06:00:00,7,7,0,92,13,79,69,61,8,16,42
28-08-2020 07:00:00,9,9,0,126,33,93,87,76,11,16,80
28-08-2020 08:00:00,13,10,3,184,53,131,82,72,10,24,100
28-08-2020 09:00:00,6,4,2,88,13,75,44,40,4,14,33
28-08-2020 10:00:00,1,0,1,59,17,42,17,11,6,5,16
28-08-2020 11:00:00,6,4,2,51,11,40,23,18,5,15,21
28-08-2020 12:00:00,6,3,3,116,45,71,48,33,15,35,49
28-08-2020 13:00:00,6,4,2,117,39,78,47,24,23,58,40
28-08-2020 14:00:00,8,2,6,129,53,76,55,29,26,58,37
28-08-2020 15:00:00,15,6,9,119,51,68,48,28,20,68,36
28-08-2020 16:00:00,10,3,7,159,87,72,70,35,35,102,59
28-08-2020 17:00:00,12,6,6,231,134,97,92,48,44,147,62
28-08-2020 18:00:00,11,4,7,168,86,82,79,38,41,112,55
28-08-2020 19:00:00,12,6,6,170,78,92,69,37,32,82,58
28-08-2020 20:00:00,15,7,8,140,73,67,33,18,15,52,28
28-08-2020 21:00:00,9,4,5,103,64,39,39,16,23,42,37
28-08-2020 22:00:00,5,2,3,48,25,23,34,18,16,40,21
28-08-2020 23:00:00,3,2,1,57,41,16,28,8,20,48,21
29-08-2020 00:00:00,0,0,0,31,25,6,6,4,2,18,6
29-08-2020 01:00:00,3,3,0,23,13,10,3,2,1,9,9
29-08-2020 02:00:00,0,0,0,7,3,4,3,2,1,4,2
29-08-2020 03:00:00,0,0,0,5,4,1,3,2,1,0,2
29-08-2020 04:00:00,0,0,0,7,5,2,3,3,0,0,1
29-08-2020 05:00:00,1,1,0,8,2,6,3,3,0,3,5
29-08-2020 06:00:00,2,1,1,32,2,30,19,17,2,12,19
29-08-2020 07:00:00,2,1,1,52,12,40,44,37,7,7,35
29-08-2020 08:00:00,7,5,2,74,26,48,34,28,6,14,39
29-08-2020 09:00:00,7,5,2,91,41,50,44,36,8,32,53
29-08-2020 10:00:00,22,10,12,118,45,73,68,33,35,50,46
29-08-2020 11:00:00,22,15,7,107,40,67,47,32,15,61,54
29-08-2020 12:00:00,17,6,11,126,45,81,68,44,24,61,53
29-08-2020 13:00:00,23,12,11,152,61,91,67,38,29,64,55
29-08-2020 14:00:00,28,17,11,138,62,76,69,41,28,77,64
29-08-2020 15:00:00,16,11,5,132,52,80,86,49,37,79,73
29-08-2020 16:00:00,12,9,3,146,67,79,71,35,36,70,66
29-08-2020 17:00:00,12,2,10,126,72,54,62,41,21,62,60
29-08-2020 18:00:00,11,5,6,117,59,58,60,33,27,82,36
29-08-2020 19:00:00,16,8,8,129,71,58,57,33,24,77,45
29-08-2020 20:00:00,5,1,4,98,51,47,35,20,15,34,35
29-08-2020 21:00:00,5,2,3,95,56,39,28,17,11,34,20
29-08-2020 22:00:00,4,1,3,64,40,24,26,13,13,30,11
29-08-2020 23:00:00,2,2,0,39,31,8,26,11,15,33,24
30-08-2020 00:00:00,0,0,0,28,21,7,10,5,5,23,10
30-08-2020 01:00:00,1,0,1,19,14,5,6,3,3,13,3
30-08-2020 02:00:00,0,0,0,7,5,2,4,2,2,9,3
30-08-2020 03:00:00,1,0,1,9,3,6,1,1,0,4,0
30-08-2020 04:00:00,0,0,0,3,3,0,2,2,0,3,3
30-08-2020 05:00:00,1,1,0,12,4,8,2,0,2,2,2
30-08-2020 06:00:00,1,1,0,19,3,16,17,14,3,12,8
30-08-2020 07:00:00,1,0,1,37,14,23,18,15,3,11,23
30-08-2020 08:00:00,0,0,0,50,14,36,20,17,3,13,32
30-08-2020 09:00:00,2,1,1,72,35,37,49,26,23,30,39
30-08-2020 10:00:00,21,15,6,114,26,88,76,58,18,58,59
30-08-2020 11:00:00,14,7,7,147,56,91,101,59,42,70,65
30-08-2020 12:00:00,21,13,8,177,65,112,94,59,35,66,67
30-08-2020 13:00:00,21,10,11,136,63,73,135,65,70,104,85
30-08-2020 14:00:00,21,13,8,157,73,84,94,52,42,89,75
30-08-2020 15:00:00,9,4,5,142,66,76,100,63,37,64,89
30-08-2020 16:00:00,17,9,8,161,63,98,80,47,33,53,66
30-08-2020 17:00:00,9,5,4,123,66,57,84,46,38,68,57
30-08-2020 18:00:00,13,6,7,147,76,71,64,36,28,57,61
30-08-2020 19:00:00,9,6,3,118,65,53,72,44,28,54,49
30-08-2020 20:00:00,3,1,2,110,60,50,50,31,19,40,42
30-08-2020 21:00:00,11,3,8,79,49,30,14,7,7,48,10
30-08-2020 22:00:00,1,1,0,53,33,20,22,6,16,24,11
30-08-2020 23:00:00,1,1,0,25,17,8,9,3,6,24,10
31-08-2020 00:00:00,2,0,2,9,6,3,5,4,1,5,4
31-08-2020 01:00:00,0,0,0,7,3,4,0,0,0,8,0
31-08-2020 02:00:00,0,0,0,6,3,3,2,0,2,5,1
31-08-2020 03:00:00,0,0,0,4,3,1,2,1,1,1,1
31-08-2020 04:00:00,0,0,0,7,4,3,1,1,0,2,6
31-08-2020 05:00:00,0,0,0,23,3,20,7,7,0,5,16
31-08-2020 06:00:00,11,8,3,96,14,82,80,73,7,7,71
31-08-2020 07:00:00,7,5,2,197,55,142,104,92,12,22,106
31-08-2020 08:00:00,32,26,6,271,64,207,159,136,23,40,183
31-08-2020 09:00:00,11,8,3,138,36,102,70,62,8,41,90
31-08-2020 10:00:00,10,4,6,110,39,71,59,48,11,25,70
31-08-2020 11:00:00,9,6,3,107,40,67,58,44,14,43,62
31-08-2020 12:00:00,13,10,3,131,43,88,65,43,22,67,59
31-08-2020 13:00:00,8,7,1,139,67,72,76,45,31,76,53
31-08-2020 14:00:00,16,6,10,135,52,83,50,26,24,71,48
31-08-2020 15:00:00,9,5,4,160,82,78,65,28,37,94,45
31-08-2020 16:00:00,17,10,7,182,101,81,90,45,45,144,63
31-08-2020 17:00:00,28,15,13,266,151,115,166,82,84,205,68
31-08-2020 18:00:00,21,10,11,249,128,121,112,49,63,170,57
31-08-2020 19:00:00,15,5,10,170,77,93,70,32,38,96,39
31-08-2020 20:00:00,16,8,8,102,33,69,61,26,35,55,49
31-08-2020 21:00:00,11,6,5,71,45,26,23,13,10,42,30
31-08-2020 22:00:00,2,1,1,58,42,16,10,7,3,36,20
31-08-2020 23:00:00,2,0,2,25,17,8,7,3,4,11,6
01-09-2020 00:00:00,0,0,0,7,6,1,4,3,1,14,4
01-09-2020 01:00:00,2,1,1,4,4,0,2,2,0,4,1
01-09-2020 02:00:00,1,1,0,2,1,1,3,1,2,3,1
01-09-2020 03:00:00,0,0,0,4,2,2,2,2,0,1,0
01-09-2020 04:00:00,0,0,0,10,2,8,0,0,0,1,6
01-09-2020 05:00:00,2,2,0,25,3,22,6,6,0,6,17
01-09-2020 06:00:00,9,7,2,109,18,91,89,79,10,13,69
01-09-2020 07:00:00,15,12,3,218,62,156,122,107,15,32,127
01-09-2020 08:00:00,27,19,8,301,81,220,180,162,18,50,221
01-09-2020 09:00:00,15,11,4,159,35,124,86,77,9,38,102
01-09-2020 10:00:00,7,5,2,74,24,50,48,33,15,30,61
01-09-2020 11:00:00,11,6,5,101,35,66,38,30,8,33,44
01-09-2020 12:00:00,12,9,3,135,49,86,72,51,21,78,55
01-09-2020 13:00:00,14,8,6,136,59,77,71,42,29,72,49
01-09-2020 14:00:00,18,7,11,130,63,67,72,43,29,70,58
01-09-2020 15:00:00,14,6,8,147,53,94,58,26,32,91,55
01-09-2020 16:00:00,17,12,5,215,124,91,97,47,50,154,67
01-09-2020 17:00:00,27,13,14,339,207,132,144,65,79,225,82
01-09-2020 18:00:00,23,12,11,295,171,124,132,58,74,189,76
01-09-2020 19:00:00,12,3,9,186,93,93,89,48,41,116,64
01-09-2020 20:00:00,18,5,13,148,68,80,70,32,38,72,39
01-09-2020 21:00:00,6,3,3,75,48,27,27,20,7,61,22
01-09-2020 22:00:00,7,2,5,58,45,13,19,15,4,34,13
01-09-2020 23:00:00,1,1,0,45,32,13,11,6,5,21,8
02-09-2020 00:00:00,0,0,0,11,7,4,3,3,0,18,8
02-09-2020 01:00:00,0,0,0,11,7,4,1,1,0,7,2
02-09-2020 02:00:00,0,0,0,6,4,2,0,0,0,2,2
02-09-2020 03:00:00,0,0,0,4,2,2,0,0,0,2,0
02-09-2020 04:00:00,0,0,0,13,2,11,1,1,0,3,4
02-09-2020 05:00:00,1,1,0,23,3,20,10,8,2,5,12
02-09-2020 06:00:00,8,8,0,78,14,64,73,63,10,12,59
02-09-2020 07:00:00,10,8,2,174,46,128,81,74,7,18,84
02-09-2020 08:00:00,10,8,2,200,53,147,85,79,6,19,102
02-09-2020 09:00:00,4,4,0,87,17,70,35,33,2,13,54
02-09-2020 10:00:00,2,1,1,51,18,33,6,4,2,14,17
02-09-2020 11:00:00,2,2,0,68,19,49,36,29,7,21,30
02-09-2020 12:00:00,6,3,3,111,43,68,49,37,12,25,41
02-09-2020 13:00:00,10,7,3,124,58,66,51,33,18,54,40
02-09-2020 14:00:00,11,6,5,124,59,65,55,37,18,50,48
02-09-2020 15:00:00,7,4,3,122,55,67,62,29,33,76,42
02-09-2020 16:00:00,7,4,3,156,80,76,83,41,42,94,45
02-09-2020 17:00:00,12,6,6,244,144,100,113,45,68,125,46
02-09-2020 18:00:00,25,7,18,223,126,97,144,76,68,126,38
02-09-2020 19:00:00,19,9,10,174,77,97,197,110,87,85,38
02-09-2020 20:00:00,9,5,4,131,80,51,55,29,26,66,25
02-09-2020 21:00:00,11,8,3,83,49,34,40,16,24,44,22
02-09-2020 22:00:00,2,0,2,52,39,13,12,7,5,41,12
02-09-2020 23:00:00,6,3,3,35,26,9,6,2,4,18,10
03-09-2020 00:00:00,1,1,0,20,11,9,3,3,0,10,5
03-09-2020 01:00:00,0,0,0,3,3,0,1,1,0,3,0
03-09-2020 02:00:00,0,0,0,2,1,1,1,1,0,2,1
03-09-2020 03:00:00,0,0,0,3,2,1,0,0,0,1,3
03-09-2020 04:00:00,0,0,0,12,2,10,0,0,0,1,5
03-09-2020 05:00:00,1,1,0,22,1,21,7,5,2,5,15
03-09-2020 06:00:00,6,6,0,89,15,74,76,69,7,9,69
03-09-2020 07:00:00,19,17,2,225,54,171,127,115,12,24,147
03-09-2020 08:00:00,31,26,5,311,83,228,177,161,16,50,192
03-09-2020 09:00:00,7,4,3,165,41,124,101,92,9,21,125
03-09-2020 10:00:00,10,5,5,87,29,58,47,34,13,27,49
03-09-2020 11:00:00,6,3,3,106,36,70,56,45,11,35,45
03-09-2020 12:00:00,13,6,7,160,49,111,63,44,19,59,72
03-09-2020 13:00:00,17,7,10,142,57,85,84,50,34,84,65
03-09-2020 14:00:00,19,7,12,135,58,77,73,46,27,74,47
03-09-2020 15:00:00,16,6,10,155,70,85,66,33,33,92,61
03-09-2020 16:00:00,11,6,5,197,103,94,91,41,50,148,62
03-09-2020 17:00:00,21,7,14,339,183,156,138,54,84,177,67
03-09-2020 18:00:00,21,11,10,256,143,113,130,55,75,200,56
03-09-2020 19:00:00,16,7,9,196,92,104,73,42,31,121,50
03-09-2020 20:00:00,15,8,7,157,80,77,70,31,39,59,43
03-09-2020 21:00:00,3,3,0,105,68,37,31,19,12,37,17
03-09-2020 22:00:00,2,2,0,63,45,18,19,10,9,38,17
03-09-2020 23:00:00,0,0,0,47,34,13,11,4,7,37,14
04-09-2020 00:00:00,0,0,0,24,19,5,4,1,3,26,2
04-09-2020 01:00:00,0,0,0,9,7,2,3,3,0,4,3
04-09-2020 02:00:00,0,0,0,4,2,2,0,0,0,4,0
04-09-2020 03:00:00,0,0,0,6,3,3,4,2,2,2,1
04-09-2020 04:00:00,1,0,1,14,5,9,1,1,0,2,6
04-09-2020 05:00:00,2,2,0,28,2,26,8,7,1,5,13
04-09-2020 06:00:00,9,8,1,87,19,68,76,72,4,12,79
04-09-2020 07:00:00,14,14,0,208,56,152,112,105,7,29,118
04-09-2020 08:00:00,31,25,6,299,70,229,164,144,20,55,195
04-09-2020 09:00:00,10,6,4,143,40,103,73,57,16,30,88
04-09-2020 10:00:00,7,5,2,95,27,68,50,37,13,31,56
04-09-2020 11:00:00,12,5,7,105,26,79,49,35,14,29,51
04-09-2020 12:00:00,11,7,4,157,55,102,63,42,21,69,50
04-09-2020 13:00:00,15,11,4,162,72,90,71,43,28,78,45
04-09-2020 14:00:00,14,4,10,168,65,103,60,37,23,72,44
04-09-2020 15:00:00,20,10,10,152,72,80,73,35,38,94,25
04-09-2020 16:00:00,16,8,8,223,124,99,107,49,58,151,50
04-09-2020 17:00:00,22,9,13,262,146,116,126,59,67,173,57
04-09-2020 18:00:00,13,7,6,186,101,85,102,49,53,126,52
04-09-2020 19:00:00,12,6,6,213,106,107,59,36,23,70,18
04-09-2020 20:00:00,13,6,7,115,44,71,58,27,31,56,52
04-09-2020 21:00:00,8,5,3,88,47,41,29,17,12,46,31
04-09-2020 22:00:00,0,0,0,62,41,21,22,6,16,46,18
04-09-2020 23:00:00,5,1,4,71,56,15,22,8,14,48,12
05-09-2020 00:00:00,0,0,0,32,22,10,9,1,8,23,3
05-09-2020 01:00:00,0,0,0,16,11,5,9,3,6,14,4
05-09-2020 02:00:00,1,1,0,10,5,5,1,1,0,8,5
05-09-2020 03:00:00,0,0,0,3,3,0,0,0,0,6,5
05-09-2020 04:00:00,0,0,0,5,2,3,3,2,1,2,3
05-09-2020 05:00:00,3,2,1,14,5,9,6,4,2,2,8
05-09-2020 06:00:00,0,0,0,31,4,27,23,20,3,7,21
05-09-2020 07:00:00,2,0,2,58,16,42,34,32,2,12,35
05-09-2020 08:00:00,8,6,2,69,28,41,38,30,8,26,40
05-09-2020 09:00:00,12,10,2,80,26,54,64,50,14,35,62
05-09-2020 10:00:00,10,7,3,96,37,59,58,48,10,39,55
05-09-2020 11:00:00,21,10,11,114,26,88,79,49,30,52,55
05-09-2020 12:00:00,18,10,8,135,54,81,75,47,28,73,58
05-09-2020 13:00:00,19,13,6,137,62,75,84,46,38,79,61
05-09-2020 14:00:00,16,7,9,158,62,96,60,34,26,73,63
05-09-2020 15:00:00,19,4,15,120,51,69,59,34,25,84,76
05-09-2020 16:00:00,2,1,1,137,68,69,55,27,28,73,64
05-09-2020 17:00:00,18,14,4,112,56,56,57,33,24,55,69
05-09-2020 18:00:00,10,5,5,118,68,50,61,40,21,72,48
05-09-2020 19:00:00,10,6,4,98,52,46,36,19,17,51,32
05-09-2020 20:00:00,5,3,2,67,41,26,27,19,8,22,24
05-09-2020 21:00:00,3,0,3,50,26,24,22,14,8,26,21
05-09-2020 22:00:00,0,0,0,40,29,11,17,8,9,30,5
05-09-2020 23:00:00,5,2,3,38,22,16,15,3,12,31,12
06-09-2020 00:00:00,1,1,0,34,22,12,9,5,4,19,3
06-09-2020 01:00:00,1,0,1,18,13,5,4,2,2,14,7
06-09-2020 02:00:00,0,0,0,6,5,1,1,0,1,7,1
06-09-2020 03:00:00,0,0,0,3,2,1,0,0,0,3,1
06-09-2020 04:00:00,0,0,0,5,4,1,1,0,1,2,2
06-09-2020 05:00:00,0,0,0,10,2,8,3,2,1,2,3
06-09-2020 06:00:00,1,1,0,19,5,14,12,10,2,5,17
06-09-2020 07:00:00,1,1,0,40,10,30,27,21,6,12,24
06-09-2020 08:00:00,7,4,3,54,20,34,26,22,4,27,32
06-09-2020 09:00:00,5,2,3,73,25,48,39,35,4,20,40
06-09-2020 10:00:00,11,7,4,80,29,51,50,32,18,43,38
06-09-2020 11:00:00,17,16,1,89,23,66,63,50,13,54,41
06-09-2020 12:00:00,15,11,4,117,50,67,71,39,32,63,33
06-09-2020 13:00:00,20,14,6,128,55,73,95,51,44,77,68
06-09-2020 14:00:00,13,12,1,118,48,70,77,39,38,78,70
06-09-2020 15:00:00,11,5,6,122,51,71,88,57,31,69,80
06-09-2020 16:00:00,13,4,9,140,71,69,82,49,33,85,69
06-09-2020 17:00:00,14,6,8,149,76,73,79,41,38,84,70
06-09-2020 18:00:00,7,3,4,117,64,53,62,38,24,74,77
06-09-2020 19:00:00,7,3,4,107,56,51,70,39,31,63,29
06-09-2020 20:00:00,6,2,4,114,51,63,56,23,33,54,32
06-09-2020 21:00:00,5,4,1,77,39,38,32,17,15,35,20
06-09-2020 22:00:00,3,2,1,42,33,9,31,17,14,43,18
06-09-2020 23:00:00,1,1,0,25,16,9,6,4,2,25,4
07-09-2020 00:00:00,2,0,2,15,9,6,7,3,4,16,2
07-09-2020 01:00:00,0,0,0,3,1,2,0,0,0,7,3
07-09-2020 02:00:00,0,0,0,8,6,2,0,0,0,1,1
07-09-2020 03:00:00,0,0,0,2,1,1,1,1,0,4,1
07-09-2020 04:00:00,0,0,0,8,3,5,0,0,0,0,7
07-09-2020 05:00:00,2,2,0,26,1,25,11,9,2,4,18
07-09-2020 06:00:00,4,4,0,83,14,69,78,72,6,10,62
07-09-2020 07:00:00,15,10,5,182,48,134,105,89,16,24,116
07-09-2020 08:00:00,19,13,6,258,61,197,121,111,10,38,143
07-09-2020 09:00:00,6,2,4,127,31,96,81,72,9,19,67
07-09-2020 10:00:00,5,4,1,67,20,47,30,24,6,21,38
07-09-2020 11:00:00,6,5,1,83,30,53,46,34,12,27,41
07-09-2020 12:00:00,9,4,5,133,52,81,34,25,9,29,32
07-09-2020 13:00:00,6,3,3,118,54,64,45,29,16,62,30
07-09-2020 14:00:00,9,3,6,101,47,54,62,38,24,51,24
07-09-2020 15:00:00,18,7,11,128,59,69,44,18,26,70,40
07-09-2020 16:00:00,16,8,8,166,92,74,87,39,48,126,31
07-09-2020 17:00:00,24,13,11,250,149,101,123,53,70,183,68
07-09-2020 18:00:00,22,8,14,217,106,111,107,44,63,124,51
07-09-2020 19:00:00,18,10,8,140,63,77,76,39,37,94,41
07-09-2020 20:00:00,12,7,5,117,69,48,53,29,24,44,35
07-09-2020 21:00:00,8,2,6,54,34,20,37,14,23,30,20
07-09-2020 22:00:00,7,3,4,39,24,15,23,10,13,34,9
07-09-2020 23:00:00,1,1,0,25,18,7,9,4,5,16,7
08-09-2020 00:00:00,3,1,2,10,7,3,2,0,2,8,5
08-09-2020 01:00:00,1,0,1,5,1,4,0,0,0,3,2
08-09-2020 02:00:00,2,1,1,4,1,3,0,0,0,2,0
08-09-2020 03:00:00,0,0,0,7,5,2,1,1,0,4,0
08-09-2020 04:00:00,0,0,0,9,2,7,0,0,0,2,3
08-09-2020 05:00:00,1,1,0,21,2,19,14,10,4,5,16
08-09-2020 06:00:00,8,6,2,109,20,89,86,77,9,15,79
08-09-2020 07:00:00,14,9,5,245,68,177,138,117,21,21,154
08-09-2020 08:00:00,36,30,6,352,79,273,195,177,18,59,260
08-09-2020 09:00:00,14,13,1,152,39,113,97,85,12,27,86
08-09-2020 10:00:00,8,5,3,74,25,49,43,34,9,27,50
08-09-2020 11:00:00,8,5,3,84,26,58,53,40,13,40,68
08-09-2020 12:00:00,14,9,5,116,52,64,63,43,20,67,61
08-09-2020 13:00:00,7,5,2,135,51,84,60,41,19,75,64
08-09-2020 14:00:00,17,10,7,167,65,102,71,44,27,85,72
08-09-2020 15:00:00,16,9,7,172,84,88,61,33,28,98,60
08-09-2020 16:00:00,26,14,12,202,115,87,105,44,61,154,36
08-09-2020 17:00:00,24,9,15,359,194,165,155,68,87,231,50
08-09-2020 18:00:00,27,10,17,309,154,155,133,62,71,208,59
08-09-2020 19:00:00,20,4,16,193,96,97,74,40,34,106,39
08-09-2020 20:00:00,13,6,7,172,89,83,80,48,32,73,50
08-09-2020 21:00:00,8,2,6,81,50,31,37,15,22,58,29
08-09-2020 22:00:00,4,2,2,60,39,21,26,11,15,31,10
08-09-2020 23:00:00,2,1,1,47,38,9,10,5,5,26,5
09-09-2020 00:00:00,3,1,2,14,11,3,5,4,1,10,8
09-09-2020 01:00:00,0,0,0,4,3,1,5,2,3,5,2
09-09-2020 02:00:00,1,0,1,0,0,0,2,0,2,3,3
09-09-2020 03:00:00,1,1,0,7,2,5,3,1,2,2,2
09-09-2020 04:00:00,0,0,0,13,3,10,0,0,0,2,5
09-09-2020 05:00:00,1,1,0,18,0,18,9,8,1,6,18
09-09-2020 06:00:00,8,6,2,109,22,87,94,85,9,19,84
09-09-2020 07:00:00,13,11,2,239,59,180,141,125,16,21,152
09-09-2020 08:00:00,32,27,5,341,73,268,209,179,30,45,232
09-09-2020 09:00:00,20,10,10,162,32,130,98,89,9,29,107
09-09-2020 10:00:00,4,4,0,105,40,65,47,37,10,34,64
09-09-2020 11:00:00,7,6,1,102,40,62,56,43,13,34,40
09-09-2020 12:00:00,13,5,8,135,46,89,61,39,22,54,49
09-09-2020 13:00:00,7,5,2,157,77,80,50,38,12,82,48
09-09-2020 14:00:00,14,8,6,126,58,68,62,34,28,73,45
09-09-2020 15:00:00,10,5,5,155,79,76,73,41,32,92,46
09-09-2020 16:00:00,22,11,11,180,104,76,105,43,62,172,61
09-09-2020 17:00:00,30,15,15,316,179,137,182,70,112,248,54
09-09-2020 18:00:00,27,13,14,281,162,119,129,53,76,214,74
09-09-2020 19:00:00,23,12,11,217,106,111,86,41,45,105,58
09-09-2020 20:00:00,13,3,10,129,54,75,70,35,35,79,37
09-09-2020 21:00:00,5,0,5,76,47,29,37,18,19,46,21
09-09-2020 22:00:00,5,2,3,57,42,15,19,11,8,46,9
09-09-2020 23:00:00,1,0,1,46,35,11,21,9,12,31,10
10-09-2020 00:00:00,2,2,0,16,11,5,3,1,2,17,3
10-09-2020 01:00:00,2,1,1,3,2,1,0,0,0,4,2
10-09-2020 02:00:00,0,0,0,3,1,2,0,0,0,3,2
10-09-2020 03:00:00,0,0,0,5,2,3,1,1,0,1,1
10-09-2020 04:00:00,0,0,0,9,2,7,0,0,0,0,4
10-09-2020 05:00:00,1,1,0,21,0,21,9,7,2,8,17
10-09-2020 06:00:00,8,8,0,91,11,80,88,80,8,15,75
10-09-2020 07:00:00,16,12,4,258,68,190,118,103,15,27,169
10-09-2020 08:00:00,33,24,9,317,78,239,198,182,16,67,226
10-09-2020 09:00:00,15,11,4,167,40,127,104,95,9,36,105
10-09-2020 10:00:00,8,4,4,82,28,54,43,31,12,29,57
10-09-2020 11:00:00,8,4,4,89,36,53,39,30,9,36,44
10-09-2020 12:00:00,7,7,0,148,46,102,60,41,19,50,43
10-09-2020 13:00:00,9,5,4,138,57,81,75,39,36,76,48
10-09-2020 14:00:00,13,10,3,120,51,69,55,35,20,72,31
10-09-2020 15:00:00,14,8,6,168,81,87,68,31,37,91,44
10-09-2020 16:00:00,17,7,10,226,128,98,98,44,54,154,63
10-09-2020 17:00:00,29,13,16,324,173,151,166,73,93,219,73
10-09-2020 18:00:00,27,13,14,273,151,122,133,62,71,209,72
10-09-2020 19:00:00,13,6,7,183,97,86,84,41,43,93,28
10-09-2020 20:00:00,7,3,4,134,76,58,55,28,27,90,35
10-09-2020 21:00:00,10,6,4,93,59,34,38,17,21,57,21
10-09-2020 22:00:00,5,2,3,50,32,18,33,17,16,43,12
10-09-2020 23:00:00,1,0,1,50,40,10,11,3,8,28,10
11-09-2020 00:00:00,2,1,1,24,16,8,6,3,3,26,6
11-09-2020 01:00:00,2,2,0,9,6,3,2,1,1,7,1
11-09-2020 02:00:00,0,0,0,2,1,1,1,1,0,4,2
11-09-2020 03:00:00,0,0,0,4,3,1,2,2,0,3,2
11-09-2020 04:00:00,0,0,0,7,4,3,2,2,0,2,3
11-09-2020 05:00:00,1,1,0,26,3,23,9,8,1,6,17
11-09-2020 06:00:00,8,6,2,115,19,96,82,75,7,16,57
11-09-2020 07:00:00,12,11,1,210,51,159,124,113,11,28,134
11-09-2020 08:00:00,21,17,4,280,67,213,151,138,13,50,178
11-09-2020 09:00:00,18,11,7,154,34,120,108,89,19,23,60
11-09-2020 10:00:00,4,1,3,84,20,64,30,20,10,28,41
11-09-2020 11:00:00,9,6,3,81,30,51,40,31,9,44,39
11-09-2020 12:00:00,6,4,2,144,56,88,49,36,13,47,49
11-09-2020 13:00:00,16,10,6,139,63,76,73,39,34,85,37
11-09-2020 14:00:00,10,4,6,139,66,73,58,35,23,88,43
11-09-2020 15:00:00,14,8,6,165,88,77,71,41,30,71,37
11-09-2020 16:00:00,15,5,10,187,98,89,81,31,50,107,35
11-09-2020 17:00:00,23,8,15,293,171,122,134,46,88,169,54
11-09-2020 18:00:00,15,8,7,204,118,86,111,53,58,146,57
11-09-2020 19:00:00,9,3,6,192,86,106,72,41,31,88,22
11-09-2020 20:00:00,13,8,5,131,69,62,47,28,19,63,42
11-09-2020 21:00:00,9,6,3,81,39,42,42,21,21,34,37
11-09-2020 22:00:00,1,1,0,60,39,21,25,14,11,34,15
11-09-2020 23:00:00,0,0,0,54,42,12,25,6,19,42,19
12-09-2020 00:00:00,1,0,1,35,24,11,7,4,3,25,4
12-09-2020 01:00:00,1,1,0,19,11,8,4,4,0,9,5
12-09-2020 02:00:00,1,1,0,12,4,8,3,1,2,11,0
12-09-2020 03:00:00,1,1,0,9,5,4,0,0,0,1,2
12-09-2020 04:00:00,1,1,0,11,6,5,3,2,1,1,3
12-09-2020 05:00:00,0,0,0,16,1,15,3,3,0,3,5
12-09-2020 06:00:00,1,1,0,34,6,28,23,21,2,12,21
12-09-2020 07:00:00,2,1,1,50,19,31,46,41,5,16,41
12-09-2020 08:00:00,5,4,1,83,30,53,36,32,4,26,59
12-09-2020 09:00:00,18,16,2,71,23,48,57,47,10,29,57
12-09-2020 10:00:00,12,9,3,110,44,66,68,43,25,53,59
12-09-2020 11:00:00,8,8,0,151,48,103,85,52,33,64,69
12-09-2020 12:00:00,22,16,6,162,54,108,97,68,29,82,62
12-09-2020 13:00:00,9,5,4,143,58,85,114,59,55,78,88
12-09-2020 14:00:00,23,16,7,160,66,94,79,57,22,81,77
12-09-2020 15:00:00,15,9,6,155,68,87,77,45,32,85,64
12-09-2020 16:00:00,17,8,9,145,55,90,68,38,30,67,47
12-09-2020 17:00:00,16,9,7,145,72,73,87,54,33,86,44
12-09-2020 18:00:00,15,5,10,139,63,76,68,28,40,78,52
12-09-2020 19:00:00,10,4,6,125,73,52,53,32,21,67,42
12-09-2020 20:00:00,17,11,6,85,42,43,36,23,13,45,46
12-09-2020 21:00:00,9,5,4,87,56,31,29,15,14,43,15
12-09-2020 22:00:00,7,4,3,55,29,26,33,16,17,36,20
12-09-2020 23:00:00,5,1,4,45,28,17,23,10,13,32,10
13-09-2020 00:00:00,4,1,3,40,27,13,6,3,3,21,5
13-09-2020 01:00:00,0,0,0,21,14,7,4,3,1,12,4
13-09-2020 02:00:00,1,1,0,10,8,2,4,2,2,7,2
13-09-2020 03:00:00,0,0,0,3,2,1,3,3,0,5,1
13-09-2020 04:00:00,1,1,0,7,5,2,0,0,0,3,2
13-09-2020 05:00:00,0,0,0,10,2,8,4,4,0,3,3
13-09-2020 06:00:00,1,1,0,23,4,19,16,16,0,5,19
13-09-2020 07:00:00,1,1,0,53,13,40,28,25,3,11,20
13-09-2020 08:00:00,5,4,1,44,12,32,28,23,5,26,33
13-09-2020 09:00:00,5,1,4,103,27,76,46,30,16,36,59
13-09-2020 10:00:00,10,7,3,122,32,90,59,39,20,56,52
13-09-2020 11:00:00,13,9,4,155,29,126,79,60,19,76,48
13-09-2020 12:00:00,24,19,5,169,52,117,116,68,48,115,66
13-09-2020 13:00:00,14,9,5,180,66,114,112,67,45,118,62
13-09-2020 14:00:00,28,15,13,138,45,93,100,56,44,117,82
13-09-2020 15:00:00,28,15,13,157,63,94,98,62,36,93,80
13-09-2020 16:00:00,18,8,10,145,61,84,82,51,31,71,80
13-09-2020 17:00:00,29,19,10,137,66,71,84,49,35,78,95
13-09-2020 18:00:00,23,10,13,145,75,70,79,39,40,85,79
13-09-2020 19:00:00,17,5,12,174,95,79,91,55,36,63,86
13-09-2020 20:00:00,7,1,6,137,65,72,63,19,44,42,46
13-09-2020 21:00:00,5,4,1,67,37,30,30,11,19,37,19
13-09-2020 22:00:00,5,4,1,68,50,18,15,9,6,36,17
13-09-2020 23:00:00,2,2,0,32,24,8,8,5,3,18,5
14-09-2020 00:00:00,0,0,0,18,10,8,7,4,3,8,3
14-09-2020 01:00:00,0,0,0,10,8,2,2,0,2,4,3
14-09-2020 02:00:00,0,0,0,6,5,1,2,2,0,3,8
14-09-2020 03:00:00,2,2,0,3,2,1,2,2,0,3,0
14-09-2020 04:00:00,0,0,0,7,4,3,1,1,0,0,1
14-09-2020 05:00:00,1,1,0,23,0,23,11,10,1,2,26
14-09-2020 06:00:00,5,5,0,91,18,73,85,79,6,14,75
14-09-2020 07:00:00,15,14,1,240,65,175,127,109,18,24,137
14-09-2020 08:00:00,22,15,7,332,74,258,166,146,20,65,218
14-09-2020 09:00:00,18,10,8,157,33,124,93,78,15,33,122
14-09-2020 10:00:00,8,8,0,81,28,53,46,38,8,24,54
14-09-2020 11:00:00,11,4,7,106,36,70,51,38,13,32,45
14-09-2020 12:00:00,10,5,5,145,47,98,71,50,21,44,62
14-09-2020 13:00:00,13,9,4,156,75,81,66,39,27,95,41
14-09-2020 14:00:00,16,7,9,148,67,81,73,47,26,102,55
14-09-2020 15:00:00,19,8,11,171,91,80,82,32,50,111,71
14-09-2020 16:00:00,28,13,15,212,123,89,108,41,67,170,61
14-09-2020 17:00:00,29,9,20,307,178,129,180,77,103,200,63
14-09-2020 18:00:00,20,8,12,271,139,132,140,53,87,187,68
14-09-2020 19:00:00,18,6,12,192,105,87,93,46,47,120,45
14-09-2020 20:00:00,9,3,6,123,69,54,57,29,28,56,23
14-09-2020 21:00:00,7,6,1,78,48,30,28,12,16,59,12
14-09-2020 22:00:00,1,1,0,39,26,13,18,9,9,26,11
14-09-2020 23:00:00,2,2,0,34,17,17,20,7,13,20,5
15-09-2020 00:00:00,0,0,0,13,10,3,3,1,2,6,4
15-09-2020 01:00:00,1,1,0,5,1,4,2,1,1,6,3
15-09-2020 02:00:00,0,0,0,1,0,1,0,0,0,2,1
15-09-2020 03:00:00,0,0,0,5,4,1,1,1,0,1,0
15-09-2020 04:00:00,0,0,0,7,2,5,1,1,0,0,3
15-09-2020 05:00:00,1,1,0,18,3,15,11,9,2,4,17
15-09-2020 06:00:00,9,7,2,104,21,83,90,83,7,14,68
15-09-2020 07:00:00,10,9,1,237,55,182,118,105,13,29,142
15-09-2020 08:00:00,20,18,2,342,73,269,176,159,17,50,233
15-09-2020 09:00:00,15,11,4,170,34,136,72,56,16,26,128
15-09-2020 10:00:00,9,6,3,96,34,62,49,40,9,21,51
15-09-2020 11:00:00,8,7,1,108,33,75,52,33,19,42,33
15-09-2020 12:00:00,12,7,5,154,54,100,38,31,7,78,63
15-09-2020 13:00:00,14,7,7,138,57,81,48,23,25,88,42
15-09-2020 14:00:00,17,11,6,137,67,70,83,47,36,77,31
15-09-2020 15:00:00,20,10,10,155,78,77,77,34,43,111,43
15-09-2020 16:00:00,19,9,10,216,105,111,131,51,80,173,50
15-09-2020 17:00:00,30,16,14,392,219,173,167,56,111,255,70
15-09-2020 18:00:00,26,17,9,336,172,164,173,88,85,220,84
15-09-2020 19:00:00,20,8,12,286,151,135,103,57,46,113,86
15-09-2020 20:00:00,14,9,5,187,106,81,73,33,40,78,77
15-09-2020 21:00:00,11,6,5,120,67,53,54,27,27,57,22
15-09-2020 22:00:00,4,4,0,73,44,29,43,21,22,35,13
15-09-2020 23:00:00,1,0,1,43,33,10,19,9,10,26,10
16-09-2020 00:00:00,1,1,0,19,14,5,6,2,4,13,4
16-09-2020 01:00:00,0,0,0,9,8,1,3,2,1,4,4
16-09-2020 02:00:00,3,1,2,6,5,1,0,0,0,2,1
16-09-2020 03:00:00,0,0,0,5,4,1,0,0,0,3,1
16-09-2020 04:00:00,0,0,0,15,7,8,1,1,0,1,5
16-09-2020 05:00:00,1,1,0,23,2,21,11,9,2,2,13
16-09-2020 06:00:00,4,4,0,104,17,87,95,85,10,20,72
16-09-2020 07:00:00,16,14,2,257,69,188,144,127,17,33,184
16-09-2020 08:00:00,36,25,11,387,93,294,204,185,19,58,228
16-09-2020 09:00:00,14,9,5,174,33,141,117,101,16,32,131
16-09-2020 10:00:00,11,7,4,104,36,68,57,37,20,43,52
16-09-2020 11:00:00,19,14,5,114,29,85,58,43,15,58,42
16-09-2020 12:00:00,10,4,6,163,49,114,76,45,31,77,71
16-09-2020 13:00:00,14,9,5,171,80,91,91,44,47,76,62
16-09-2020 14:00:00,23,12,11,145,57,88,70,34,36,109,60
16-09-2020 15:00:00,19,12,7,148,76,72,35,19,16,99,55
16-09-2020 16:00:00,17,6,11,216,120,96,15,9,6,163,62
16-09-2020 17:00:00,18,4,14,398,243,155,120,53,67,239,52
16-09-2020 18:00:00,21,6,15,285,151,134,123,46,77,220,71
16-09-2020 19:00:00,13,4,9,178,89,89,112,60,52,74,56
16-09-2020 20:00:00,8,6,2,163,81,82,69,29,40,90,25
16-09-2020 21:00:00,5,3,2,80,59,21,38,13,25,60,25
16-09-2020 22:00:00,4,1,3,71,53,18,27,11,16,43,27
16-09-2020 23:00:00,3,3,0,47,39,8,11,5,6,27,8
17-09-2020 00:00:00,3,1,2,13,8,5,1,1,0,14,2
17-09-2020 01:00:00,0,0,0,6,4,2,2,0,2,10,2
17-09-2020 02:00:00,0,0,0,2,2,0,0,0,0,3,3
17-09-2020 03:00:00,0,0,0,3,1,2,0,0,0,1,0
17-09-2020 04:00:00,1,0,1,7,2,5,1,1,0,4,2
17-09-2020 05:00:00,0,0,0,21,2,19,12,11,1,3,19
17-09-2020 06:00:00,4,4,0,112,25,87,101,92,9,14,71
17-09-2020 07:00:00,12,12,0,257,65,192,123,108,15,41,142
17-09-2020 08:00:00,31,25,6,347,71,276,183,160,23,76,215
17-09-2020 09:00:00,17,13,4,189,54,135,107,93,14,40,113
17-09-2020 10:00:00,10,7,3,98,31,67,53,37,16,24,62
17-09-2020 11:00:00,11,7,4,130,47,83,59,41,18,44,51
17-09-2020 12:00:00,19,9,10,151,55,96,76,48,28,75,94
17-09-2020 13:00:00,17,12,5,154,61,93,78,48,30,88,62
17-09-2020 14:00:00,13,7,6,159,66,93,62,28,34,91,64
17-09-2020 15:00:00,23,15,8,195,98,97,83,40,43,109,79
17-09-2020 16:00:00,16,8,8,209,111,98,139,59,80,160,75
17-09-2020 17:00:00,19,9,10,385,205,180,162,81,81,249,83
17-09-2020 18:00:00,32,18,14,305,169,136,172,78,94,225,100
17-09-2020 19:00:00,15,5,10,212,109,103,77,32,45,131,73
17-09-2020 20:00:00,18,12,6,163,90,73,85,45,40,96,52
17-09-2020 21:00:00,14,2,12,94,58,36,57,17,40,58,30
17-09-2020 22:00:00,8,5,3,72,45,27,31,15,16,51,19
17-09-2020 23:00:00,5,3,2,57,40,17,16,8,8,41,21
18-09-2020 00:00:00,0,0,0,25,18,7,11,5,6,25,9
18-09-2020 01:00:00,0,0,0,9,9,0,3,2,1,8,2
18-09-2020 02:00:00,0,0,0,4,3,1,3,3,0,1,1
18-09-2020 03:00:00,0,0,0,4,2,2,1,0,1,2,0
18-09-2020 04:00:00,1,0,1,10,5,5,3,3,0,3,3
18-09-2020 05:00:00,0,0,0,22,0,22,12,10,2,5,19
18-09-2020 06:00:00,10,8,2,106,17,89,81,76,5,15,55
18-09-2020 07:00:00,8,7,1,233,70,163,130,110,20,31,141
18-09-2020 08:00:00,30,25,5,307,80,227,176,159,17,62,183
18-09-2020 09:00:00,15,10,5,168,40,128,85,70,15,27,89
18-09-2020 10:00:00,10,7,3,106,26,80,58,45,13,36,62
18-09-2020 11:00:00,19,10,9,98,42,56,64,50,14,46,45
18-09-2020 12:00:00,13,12,1,156,48,108,77,54,23,63,62
18-09-2020 13:00:00,14,8,6,157,62,95,88,53,35,93,53
18-09-2020 14:00:00,11,4,7,145,63,82,80,37,43,100,49
18-09-2020 15:00:00,13,5,8,173,91,82,81,36,45,115,38
18-09-2020 16:00:00,20,9,11,219,127,92,107,50,57,139,42
18-09-2020 17:00:00,24,9,15,270,163,107,150,63,87,198,63
18-09-2020 18:00:00,4,2,2,221,123,98,85,42,43,122,54
18-09-2020 19:00:00,8,4,4,219,119,100,84,61,23,87,52
18-09-2020 20:00:00,5,1,4,161,71,90,53,25,28,67,34
18-09-2020 21:00:00,5,1,4,79,44,35,44,24,20,49,26
18-09-2020 22:00:00,4,3,1,55,33,22,29,13,16,42,20
18-09-2020 23:00:00,3,3,0,59,47,12,22,8,14,44,12
19-09-2020 00:00:00,5,3,2,48,30,18,11,4,7,19,7
19-09-2020 01:00:00,1,0,1,17,8,9,5,3,2,7,6
19-09-2020 02:00:00,1,1,0,10,7,3,3,3,0,10,4
19-09-2020 03:00:00,0,0,0,12,8,4,6,0,6,6,1
19-09-2020 04:00:00,0,0,0,14,9,5,2,2,0,4,4
19-09-2020 05:00:00,1,1,0,7,0,7,2,2,0,3,3
19-09-2020 06:00:00,2,2,0,39,4,35,25,24,1,16,23
19-09-2020 07:00:00,5,4,1,56,12,44,47,42,5,16,34
19-09-2020 08:00:00,11,7,4,70,22,48,33,23,10,27,37
19-09-2020 09:00:00,10,8,2,84,27,57,52,44,8,49,56
19-09-2020 10:00:00,16,6,10,115,36,79,70,43,27,41,56
19-09-2020 11:00:00,16,6,10,110,34,76,65,42,23,42,48
19-09-2020 12:00:00,18,11,7,135,50,85,70,48,22,78,60
19-09-2020 13:00:00,18,10,8,135,70,65,83,41,42,89,72
19-09-2020 14:00:00,27,12,15,177,79,98,88,44,44,98,79
19-09-2020 15:00:00,13,8,5,155,78,77,66,37,29,72,49
19-09-2020 16:00:00,13,5,8,116,58,58,56,29,27,90,45
19-09-2020 17:00:00,18,7,11,103,61,42,67,39,28,87,62
19-09-2020 18:00:00,8,4,4,165,87,78,71,48,23,89,60
19-09-2020 19:00:00,11,7,4,121,63,58,69,43,26,64,51
19-09-2020 20:00:00,5,4,1,79,44,35,41,31,10,49,46
19-09-2020 21:00:00,10,2,8,64,41,23,34,14,20,47,22
19-09-2020 22:00:00,4,3,1,44,32,12,22,10,12,29,15
19-09-2020 23:00:00,3,2,1,54,34,20,13,8,5,18,9
20-09-2020 00:00:00,1,1,0,21,9,12,9,3,6,13,8
20-09-2020 01:00:00,1,0,1,14,7,7,5,4,1,8,2
20-09-2020 02:00:00,0,0,0,8,4,4,0,0,0,4,2
20-09-2020 03:00:00,0,0,0,5,5,0,0,0,0,3,1
20-09-2020 04:00:00,0,0,0,4,2,2,1,0,1,1,1
20-09-2020 05:00:00,0,0,0,3,2,1,1,1,0,3,1
20-09-2020 06:00:00,3,3,0,28,9,19,11,11,0,10,14
20-09-2020 07:00:00,2,1,1,35,5,30,25,21,4,20,29
20-09-2020 08:00:00,4,3,1,46,12,34,20,16,4,32,24
20-09-2020 09:00:00,3,3,0,66,27,39,39,22,17,41,40
20-09-2020 10:00:00,13,7,6,90,29,61,68,42,26,52,53
20-09-2020 11:00:00,25,14,11,96,32,64,77,47,30,75,62
20-09-2020 12:00:00,22,11,11,170,77,93,102,63,39,83,65
20-09-2020 13:00:00,30,15,15,146,64,82,93,54,39,87,69
20-09-2020 14:00:00,15,13,2,149,61,88,104,66,38,85,50
20-09-2020 15:00:00,20,12,8,154,61,93,107,66,41,78,55
20-09-2020 16:00:00,16,12,4,130,65,65,81,41,40,67,91
20-09-2020 17:00:00,6,3,3,117,68,49,68,40,28,73,57
20-09-2020 18:00:00,20,9,11,134,76,58,63,35,28,55,34
20-09-2020 19:00:00,10,2,8,136,75,61,62,36,26,47,30
20-09-2020 20:00:00,11,6,5,82,48,34,48,24,24,51,26
20-09-2020 21:00:00,6,1,5,53,28,25,31,21,10,34,8
20-09-2020 22:00:00,2,1,1,36,24,12,21,12,9,18,14
20-09-2020 23:00:00,3,1,2,18,11,7,11,4,7,16,5
21-09-2020 00:00:00,1,0,1,9,5,4,1,1,0,4,4
21-09-2020 01:00:00,0,0,0,4,4,0,1,0,1,3,2
21-09-2020 02:00:00,0,0,0,1,1,0,2,2,0,3,1
21-09-2020 03:00:00,0,0,0,3,1,2,1,1,0,0,0
21-09-2020 04:00:00,0,0,0,8,3,5,0,0,0,0,3
21-09-2020 05:00:00,1,1,0,26,1,25,13,10,3,4,18
21-09-2020 06:00:00,6,6,0,110,18,92,88,83,5,9,74
21-09-2020 07:00:00,14,12,2,233,65,168,126,111,15,33,147
21-09-2020 08:00:00,30,22,8,330,92,238,156,141,15,54,205
21-09-2020 09:00:00,19,9,10,156,36,120,73,52,21,34,111
21-09-2020 10:00:00,7,5,2,101,28,73,54,33,21,37,34
21-09-2020 11:00:00,10,3,7,95,42,53,57,37,20,32,55
21-09-2020 12:00:00,16,10,6,138,47,91,51,29,22,75,49
21-09-2020 13:00:00,11,7,4,169,60,109,66,47,19,67,46
21-09-2020 14:00:00,16,10,6,135,59,76,72,47,25,94,34
21-09-2020 15:00:00,21,15,6,164,69,95,70,31,39,110,60
21-09-2020 16:00:00,22,13,9,216,120,96,112,48,64,165,69
21-09-2020 17:00:00,29,15,14,394,211,183,167,66,101,233,90
21-09-2020 18:00:00,26,14,12,328,171,157,132,59,73,207,81
21-09-2020 19:00:00,9,5,4,190,103,87,92,53,39,92,60
21-09-2020 20:00:00,16,7,9,153,88,65,45,18,27,49,50
21-09-2020 21:00:00,7,4,3,80,51,29,29,9,20,43,20
21-09-2020 22:00:00,3,2,1,50,39,11,16,10,6,29,9
21-09-2020 23:00:00,1,0,1,23,11,12,13,6,7,25,7
22-09-2020 00:00:00,0,0,0,19,11,8,0,0,0,12,3
22-09-2020 01:00:00,0,0,0,6,6,0,2,1,1,3,1
22-09-2020 02:00:00,1,1,0,4,0,4,0,0,0,1,4
22-09-2020 03:00:00,0,0,0,1,1,0,1,1,0,2,1
22-09-2020 04:00:00,0,0,0,11,6,5,0,0,0,0,2
22-09-2020 05:00:00,1,1,0,21,2,19,15,13,2,2,17
22-09-2020 06:00:00,5,5,0,115,21,94,85,81,4,15,73
22-09-2020 07:00:00,23,19,4,246,64,182,132,107,25,25,143
22-09-2020 08:00:00,31,23,8,342,88,254,169,154,15,64,246
22-09-2020 09:00:00,9,7,2,154,35,119,79,67,12,38,107
22-09-2020 10:00:00,7,6,1,92,34,58,46,38,8,32,56
22-09-2020 11:00:00,7,3,4,91,34,57,53,38,15,28,46
22-09-2020 12:00:00,17,11,6,141,57,84,58,36,22,47,52
22-09-2020 13:00:00,13,7,6,152,64,88,62,36,26,69,49
22-09-2020 14:00:00,13,6,7,134,60,74,61,38,23,70,58
22-09-2020 15:00:00,18,12,6,145,81,64,77,39,38,117,45
22-09-2020 16:00:00,20,12,8,195,119,76,99,39,60,151,59
22-09-2020 17:00:00,35,16,19,332,190,142,168,69,99,191,49
22-09-2020 18:00:00,14,5,9,277,158,119,132,65,67,182,46
22-09-2020 19:00:00,7,1,6,188,108,80,76,36,40,101,36
22-09-2020 20:00:00,8,3,5,120,66,54,41,13,28,62,36
22-09-2020 21:00:00,2,2,0,63,43,20,31,17,14,34,17
22-09-2020 22:00:00,3,1,2,35,23,12,21,13,8,21,9
22-09-2020 23:00:00,0,0,0,20,12,8,8,2,6,9,3
23-09-2020 00:00:00,2,2,0,7,5,2,2,0,2,8,2
23-09-2020 01:00:00,0,0,0,2,2,0,3,2,1,5,1
23-09-2020 02:00:00,0,0,0,1,0,1,0,0,0,0,1
23-09-2020 03:00:00,0,0,0,3,2,1,0,0,0,1,0
23-09-2020 04:00:00,0,0,0,11,5,6,2,1,1,1,2
23-09-2020 05:00:00,0,0,0,22,0,22,16,14,2,3,23
23-09-2020 06:00:00,7,6,1,97,17,80,94,87,7,13,74
23-09-2020 07:00:00,21,17,4,218,57,161,133,117,16,25,153
23-09-2020 08:00:00,39,28,11,341,68,273,171,156,15,50,240
23-09-2020 09:00:00,11,7,4,169,46,123,82,69,13,27,85
23-09-2020 10:00:00,7,5,2,91,29,62,44,29,15,25,51
23-09-2020 11:00:00,13,9,4,107,39,68,59,44,15,35,40
23-09-2020 12:00:00,18,11,7,142,57,85,86,58,28,65,44
23-09-2020 13:00:00,17,7,10,164,79,85,68,36,32,54,41
23-09-2020 14:00:00,17,12,5,152,65,87,63,44,19,80,33
23-09-2020 15:00:00,13,9,4,147,88,59,77,38,39,88,40
23-09-2020 16:00:00,19,8,11,231,112,119,109,51,58,139,46
23-09-2020 17:00:00,34,20,14,299,190,109,185,64,121,235,53
23-09-2020 18:00:00,23,7,16,298,168,130,116,55,61,186,77
23-09-2020 19:00:00,12,7,5,209,112,97,102,58,44,123,36
23-09-2020 20:00:00,10,5,5,135,83,52,63,33,30,48,40
23-09-2020 21:00:00,8,3,5,74,46,28,34,18,16,56,37
23-09-2020 22:00:00,5,3,2,48,35,13,26,7,19,35,11
23-09-2020 23:00:00,1,1,0,26,17,9,6,2,4,23,12
24-09-2020 00:00:00,0,0,0,14,10,4,4,2,2,10,5
24-09-2020 01:00:00,0,0,0,4,1,3,2,2,0,3,1
24-09-2020 02:00:00,0,0,0,0,0,0,0,0,0,4,1
24-09-2020 03:00:00,0,0,0,4,2,2,0,0,0,0,0
24-09-2020 04:00:00,0,0,0,7,3,4,1,1,0,2,1
24-09-2020 05:00:00,1,1,0,22,1,21,12,11,1,4,12
24-09-2020 06:00:00,7,7,0,81,20,61,65,59,6,17,43
24-09-2020 07:00:00,10,9,1,158,37,121,93,83,10,19,101
24-09-2020 08:00:00,22,18,4,272,64,208,141,126,15,51,192
24-09-2020 09:00:00,12,10,2,136,29,107,80,67,13,20,79
24-09-2020 10:00:00,5,3,2,80,29,51,43,28,15,20,29
24-09-2020 11:00:00,9,2,7,84,22,62,40,33,7,21,29
24-09-2020 12:00:00,5,3,2,116,38,78,37,21,16,37,31
24-09-2020 13:00:00,9,5,4,135,59,76,38,23,15,51,35
24-09-2020 14:00:00,20,12,8,99,45,54,49,32,17,38,11
24-09-2020 15:00:00,16,11,5,116,61,55,54,29,25,71,44
24-09-2020 16:00:00,13,7,6,152,89,63,66,33,33,100,33
24-09-2020 17:00:00,22,13,9,261,156,105,119,57,62,154,27
24-09-2020 18:00:00,15,3,12,204,115,89,89,28,61,124,14
24-09-2020 19:00:00,10,3,7,128,75,53,62,31,31,56,8
24-09-2020 20:00:00,4,2,2,93,55,38,32,15,17,48,20
24-09-2020 21:00:00,2,2,0,68,46,22,39,16,23,36,16
24-09-2020 22:00:00,2,1,1,39,29,10,15,8,7,15,6
24-09-2020 23:00:00,2,2,0,20,14,6,7,3,4,17,3
25-09-2020 00:00:00,1,0,1,11,10,1,6,1,5,8,1
25-09-2020 01:00:00,1,0,1,2,1,1,2,0,2,1,0
25-09-2020 02:00:00,0,0,0,1,1,0,0,0,0,2,2
25-09-2020 03:00:00,0,0,0,3,1,2,1,1,0,1,0
25-09-2020 04:00:00,2,2,0,9,4,5,1,1,0,1,2
25-09-2020 05:00:00,0,0,0,23,2,21,14,13,1,4,17
25-09-2020 06:00:00,8,8,0,85,11,74,75,69,6,14,61
25-09-2020 07:00:00,10,8,2,205,56,149,123,105,18,31,124
25-09-2020 08:00:00,26,24,2,321,76,245,163,143,20,51,205
25-09-2020 09:00:00,11,9,2,164,38,126,82,70,12,30,69
25-09-2020 10:00:00,9,7,2,104,24,80,52,36,16,25,33
25-09-2020 11:00:00,16,11,5,103,39,64,61,41,20,44,42
25-09-2020 12:00:00,18,9,9,156,54,102,92,47,45,57,37
25-09-2020 13:00:00,12,5,7,180,74,106,81,51,30,80,39
25-09-2020 14:00:00,25,12,13,134,53,81,77,40,37,76,47
25-09-2020 15:00:00,9,7,2,161,96,65,64,33,31,85,38
25-09-2020 16:00:00,16,6,10,190,100,90,111,46,65,128,30
25-09-2020 17:00:00,18,7,11,287,163,124,133,56,77,180,58
25-09-2020 18:00:00,8,2,6,242,124,118,103,47,56,172,60
25-09-2020 19:00:00,20,12,8,200,103,97,89,68,21,102,54
25-09-2020 20:00:00,11,5,6,108,60,48,54,29,25,60,40
25-09-2020 21:00:00,3,1,2,80,49,31,35,19,16,51,14
25-09-2020 22:00:00,11,3,8,69,46,23,29,11,18,30,13
25-09-2020 23:00:00,2,1,1,46,31,15,11,5,6,22,12
26-09-2020 00:00:00,1,1,0,26,17,9,16,8,8,16,6
26-09-2020 01:00:00,2,1,1,17,13,4,4,1,3,11,2
26-09-2020 02:00:00,1,1,0,5,3,2,0,0,0,5,2
26-09-2020 03:00:00,0,0,0,6,2,4,2,2,0,2,2
26-09-2020 04:00:00,0,0,0,7,6,1,3,3,0,3,5
26-09-2020 05:00:00,0,0,0,14,4,10,1,1,0,1,2
26-09-2020 06:00:00,0,0,0,32,7,25,27,24,3,10,21
26-09-2020 07:00:00,4,1,3,55,13,42,40,34,6,15,33
26-09-2020 08:00:00,5,4,1,94,47,47,37,27,10,33,34
26-09-2020 09:00:00,16,13,3,116,33,83,66,50,16,45,59
26-09-2020 10:00:00,16,7,9,115,40,75,63,37,26,76,78
26-09-2020 11:00:00,22,17,5,165,58,107,96,61,35,89,70
26-09-2020 12:00:00,21,11,10,202,97,105,118,72,46,104,80
26-09-2020 13:00:00,22,11,11,169,69,100,116,62,54,140,80
26-09-2020 14:00:00,27,12,15,190,81,109,131,74,57,120,70
26-09-2020 15:00:00,23,15,8,144,76,68,109,58,51,89,94
26-09-2020 16:00:00,42,19,23,135,53,82,85,44,41,86,72
26-09-2020 17:00:00,13,9,4,157,77,80,85,43,42,83,78
26-09-2020 18:00:00,11,3,8,177,96,81,73,48,25,71,74
26-09-2020 19:00:00,9,3,6,155,77,78,64,45,19,62,64
26-09-2020 20:00:00,13,7,6,114,57,57,40,23,17,60,38
26-09-2020 21:00:00,9,2,7,77,48,29,41,19,22,40,33
26-09-2020 22:00:00,1,0,1,52,33,19,28,12,16,27,21
26-09-2020 23:00:00,3,3,0,44,29,15,18,6,12,22,10
27-09-2020 00:00:00,1,0,1,25,15,10,10,6,4,15,3
27-09-2020 01:00:00,0,0,0,13,8,5,3,1,2,8,6
27-09-2020 02:00:00,0,0,0,7,4,3,0,0,0,7,4
27-09-2020 03:00:00,0,0,0,7,3,4,0,0,0,3,0
27-09-2020 04:00:00,0,0,0,7,4,3,3,2,1,2,3
27-09-2020 05:00:00,0,0,0,9,3,6,0,0,0,2,5
27-09-2020 06:00:00,0,0,0,16,4,12,7,5,2,6,8
27-09-2020 07:00:00,1,1,0,42,12,30,27,21,6,12,17
27-09-2020 08:00:00,7,5,2,76,40,36,33,27,6,58,35
27-09-2020 09:00:00,9,4,5,99,28,71,52,30,22,46,41
27-09-2020 10:00:00,14,6,8,118,38,80,91,42,49,75,53
27-09-2020 11:00:00,27,9,18,157,43,114,98,46,52,86,48
27-09-2020 12:00:00,22,15,7,159,42,117,117,74,43,97,75
27-09-2020 13:00:00,26,13,13,200,84,116,127,74,53,121,96
27-09-2020 14:00:00,34,19,15,182,62,120,125,62,63,80,82
27-09-2020 15:00:00,16,9,7,182,78,104,127,74,53,89,79
27-09-2020 16:00:00,35,12,23,175,92,83,96,51,45,88,81
27-09-2020 17:00:00,19,11,8,168,80,88,104,60,44,89,84
27-09-2020 18:00:00,17,8,9,172,95,77,87,53,34,75,79
27-09-2020 19:00:00,13,5,8,141,71,70,51,26,25,59,48
27-09-2020 20:00:00,24,4,20,78,36,42,37,21,16,46,29
27-09-2020 21:00:00,12,8,4,73,50,23,46,25,21,33,15
27-09-2020 22:00:00,0,0,0,41,31,10,16,10,6,22,16
27-09-2020 23:00:00,1,1,0,25,19,6,10,7,3,12,8
28-09-2020 00:00:00,0,0,0,15,10,5,3,1,2,9,1
28-09-2020 01:00:00,1,1,0,1,0,1,4,0,4,7,2
28-09-2020 02:00:00,0,0,0,2,1,1,1,0,1,4,1
28-09-2020 03:00:00,0,0,0,4,3,1,1,1,0,1,0
28-09-2020 04:00:00,0,0,0,10,5,5,0,0,0,0,7
28-09-2020 05:00:00,2,2,0,29,3,26,14,12,2,3,24
28-09-2020 06:00:00,9,9,0,85,11,74,84,80,4,16,53
28-09-2020 07:00:00,16,11,5,194,59,135,129,106,23,26,138
28-09-2020 08:00:00,30,24,6,311,78,233,143,135,8,48,176
28-09-2020 09:00:00,16,11,5,150,42,108,78,63,15,25,93
28-09-2020 10:00:00,3,2,1,69,22,47,29,24,5,20,43
28-09-2020 11:00:00,10,3,7,76,24,52,46,37,9,28,38
28-09-2020 12:00:00,2,1,1,109,35,74,48,26,22,44,34
28-09-2020 13:00:00,11,9,2,128,59,69,58,40,18,45,37
28-09-2020 14:00:00,14,8,6,119,52,67,51,34,17,52,30
28-09-2020 15:00:00,15,7,8,134,64,70,52,35,17,73,57
28-09-2020 16:00:00,23,11,12,219,121,98,104,37,67,126,49
28-09-2020 17:00:00,21,6,15,308,179,129,156,60,96,225,57
28-09-2020 18:00:00,21,7,14,258,142,116,116,44,72,188,48
28-09-2020 19:00:00,18,10,8,137,74,63,81,38,43,90,43
28-09-2020 20:00:00,13,6,7,88,38,50,39,24,15,50,22
28-09-2020 21:00:00,5,3,2,78,52,26,24,11,13,37,22
28-09-2020 22:00:00,3,0,3,31,23,8,14,9,5,33,7
28-09-2020 23:00:00,2,2,0,23,19,4,11,6,5,14,5
29-09-2020 00:00:00,0,0,0,9,5,4,3,0,3,8,2
29-09-2020 01:00:00,0,0,0,6,2,4,1,1,0,4,1
29-09-2020 02:00:00,1,1,0,1,0,1,0,0,0,5,1
29-09-2020 03:00:00,0,0,0,3,2,1,2,2,0,1,0
29-09-2020 04:00:00,1,1,0,7,4,3,0,0,0,2,7
29-09-2020 05:00:00,2,2,0,32,4,28,15,13,2,4,16
29-09-2020 06:00:00,11,11,0,104,13,91,97,92,5,13,59
29-09-2020 07:00:00,21,17,4,244,63,181,126,104,22,35,125
29-09-2020 08:00:00,40,34,6,357,88,269,203,188,15,44,201
29-09-2020 09:00:00,11,9,2,160,42,118,87,68,19,45,113
29-09-2020 10:00:00,13,8,5,87,28,59,60,43,17,39,46
29-09-2020 11:00:00,8,4,4,99,31,68,50,40,10,37,67
29-09-2020 12:00:00,17,12,5,154,54,100,77,53,24,56,56
29-09-2020 13:00:00,16,9,7,146,65,81,72,43,29,84,62
29-09-2020 14:00:00,19,9,10,159,69,90,72,41,31,80,45
29-09-2020 15:00:00,11,7,4,159,78,81,84,42,42,97,54
29-09-2020 16:00:00,26,14,12,238,130,108,109,55,54,161,78
29-09-2020 17:00:00,32,13,19,372,212,160,187,88,99,236,68
29-09-2020 18:00:00,26,8,18,300,175,125,145,47,98,202,72
29-09-2020 19:00:00,18,12,6,172,94,78,82,39,43,100,48
29-09-2020 20:00:00,2,1,1,139,82,57,67,36,31,66,36
29-09-2020 21:00:00,4,2,2,85,48,37,30,13,17,29,16
29-09-2020 22:00:00,2,1,1,49,34,15,30,21,9,27,15
29-09-2020 23:00:00,2,0,2,38,31,7,12,9,3,23,3
30-09-2020 00:00:00,0,0,0,14,9,5,2,1,1,7,5
30-09-2020 01:00:00,0,0,0,2,1,1,1,1,0,3,1
30-09-2020 02:00:00,0,0,0,1,1,0,0,0,0,3,3
30-09-2020 03:00:00,0,0,0,2,1,1,1,1,0,1,0
30-09-2020 04:00:00,1,1,0,12,5,7,2,1,1,0,3
30-09-2020 05:00:00,2,2,0,23,0,23,10,9,1,3,13
30-09-2020 06:00:00,8,8,0,78,13,65,71,66,5,10,50
30-09-2020 07:00:00,13,11,2,156,44,112,89,78,11,10,92
30-09-2020 08:00:00,26,19,7,239,54,185,128,115,13,20,100
30-09-2020 09:00:00,10,6,4,135,28,107,75,70,5,23,82
30-09-2020 10:00:00,4,2,2,76,21,55,27,23,4,24,42
30-09-2020 11:00:00,9,5,4,72,31,41,39,32,7,14,42
30-09-2020 12:00:00,6,4,2,109,47,62,50,33,17,46,37
30-09-2020 13:00:00,9,7,2,121,51,70,48,28,20,57,52
30-09-2020 14:00:00,10,5,5,101,44,57,57,32,25,54,19
30-09-2020 15:00:00,13,5,8,106,49,57,40,22,18,42,39
30-09-2020 16:00:00,10,3,7,139,75,64,50,21,29,96,34
30-09-2020 17:00:00,17,8,9,249,159,90,101,41,60,165,29
30-09-2020 18:00:00,13,7,6,198,109,89,84,29,55,132,33
30-09-2020 19:00:00,9,6,3,131,66,65,67,43,24,68,28
30-09-2020 20:00:00,5,2,3,99,60,39,23,12,11,50,25
30-09-2020 21:00:00,1,0,1,63,39,24,32,14,18,26,20
30-09-2020 22:00:00,2,1,1,48,32,16,8,2,6,23,6
30-09-2020 23:00:00,4,1,3,21,16,5,5,0,5,24,6
01-10-2020 00:00:00,1,0,1,8,4,4,4,2,2,8,9
01-10-2020 01:00:00,0,0,0,4,4,0,2,2,0,5,2
01-10-2020 02:00:00,0,0,0,1,0,1,2,0,2,2,2
01-10-2020 03:00:00,0,0,0,1,1,0,2,0,2,1,0
01-10-2020 04:00:00,0,0,0,8,3,5,1,1,0,1,7
01-10-2020 05:00:00,1,1,0,19,1,18,10,9,1,3,12
01-10-2020 06:00:00,5,5,0,90,13,77,85,79,6,11,61
01-10-2020 07:00:00,24,23,1,213,53,160,112,97,15,31,124
01-10-2020 08:00:00,28,23,5,312,69,243,173,146,27,47,217
01-10-2020 09:00:00,7,6,1,152,39,113,88,71,17,30,103
01-10-2020 10:00:00,8,5,3,121,40,81,45,35,10,41,63
01-10-2020 11:00:00,19,14,5,113,44,69,63,39,24,23,52
01-10-2020 12:00:00,10,7,3,157,58,99,69,47,22,72,68
01-10-2020 13:00:00,14,12,2,164,58,106,76,50,26,67,51
01-10-2020 14:00:00,22,13,9,159,73,86,60,34,26,70,30
01-10-2020 15:00:00,19,10,9,131,75,56,85,41,44,79,33
01-10-2020 16:00:00,21,11,10,193,99,94,80,33,47,135,47
01-10-2020 17:00:00,18,9,9,334,200,134,137,61,76,213,58
01-10-2020 18:00:00,20,11,9,207,112,95,106,54,52,159,35
01-10-2020 19:00:00,7,2,5,153,82,71,63,33,30,78,37
01-10-2020 20:00:00,11,5,6,118,77,41,36,13,23,58,26
01-10-2020 21:00:00,5,5,0,68,44,24,32,9,23,41,21
01-10-2020 22:00:00,5,1,4,42,27,15,15,3,12,32,11
01-10-2020 23:00:00,2,0,2,26,17,9,6,3,3,13,7
02-10-2020 00:00:00,1,1,0,11,5,6,2,0,2,4,3
02-10-2020 01:00:00,0,0,0,3,3,0,0,0,0,3,0
02-10-2020 02:00:00,0,0,0,0,0,0,0,0,0,2,0
02-10-2020 03:00:00,1,0,1,2,1,1,1,1,0,0,1
02-10-2020 04:00:00,1,0,1,7,4,3,3,2,1,1,4
02-10-2020 05:00:00,0,0,0,24,5,19,11,11,0,3,18
02-10-2020 06:00:00,6,6,0,88,11,77,72,69,3,13,53
02-10-2020 07:00:00,9,8,1,187,38,149,115,102,13,28,118
02-10-2020 08:00:00,33,28,5,285,69,216,145,124,21,51,193
02-10-2020 09:00:00,13,6,7,149,33,116,85,68,17,34,92
02-10-2020 10:00:00,9,9,0,123,40,83,41,28,13,21,50
02-10-2020 11:00:00,10,6,4,113,40,73,49,39,10,33,34
02-10-2020 12:00:00,19,12,7,155,53,102,72,49,23,59,55
02-10-2020 13:00:00,21,10,11,169,76,93,75,38,37,93,66
02-10-2020 14:00:00,15,7,8,170,77,93,83,45,38,95,46
02-10-2020 15:00:00,19,11,8,166,84,82,92,53,39,93,66
02-10-2020 16:00:00,19,10,9,177,99,78,99,44,55,131,59
02-10-2020 17:00:00,18,8,10,321,170,151,122,51,71,188,69
02-10-2020 18:00:00,20,9,11,246,135,111,116,63,53,148,59
02-10-2020 19:00:00,11,5,6,192,93,99,81,41,40,96,41
02-10-2020 20:00:00,8,3,5,139,75,64,62,36,26,68,34
02-10-2020 21:00:00,6,4,2,94,48,46,44,22,22,51,17
02-10-2020 22:00:00,3,2,1,59,45,14,34,13,21,43,13
02-10-2020 23:00:00,0,0,0,53,39,14,28,14,14,27,14
03-10-2020 00:00:00,0,0,0,35,23,12,10,7,3,16,4
03-10-2020 01:00:00,1,1,0,12,8,4,0,0,0,9,4
03-10-2020 02:00:00,2,1,1,5,2,3,2,2,0,3,3
03-10-2020 03:00:00,1,0,1,10,8,2,2,0,2,2,3
03-10-2020 04:00:00,1,1,0,5,3,2,1,1,0,3,7
03-10-2020 05:00:00,1,1,0,10,6,4,2,1,1,3,5
03-10-2020 06:00:00,1,1,0,33,5,28,19,17,2,7,19
03-10-2020 07:00:00,5,2,3,63,21,42,45,39,6,16,40
03-10-2020 08:00:00,5,5,0,80,36,44,30,26,4,27,34
03-10-2020 09:00:00,11,6,5,80,26,54,68,44,24,50,53
03-10-2020 10:00:00,10,8,2,104,33,71,86,56,30,40,46
03-10-2020 11:00:00,13,6,7,118,40,78,55,33,22,68,59
03-10-2020 12:00:00,13,8,5,149,52,97,68,39,29,62,72
03-10-2020 13:00:00,14,8,6,146,75,71,83,53,30,101,85
03-10-2020 14:00:00,13,7,6,131,52,79,68,38,30,79,69
03-10-2020 15:00:00,11,8,3,135,64,71,78,40,38,65,64
03-10-2020 16:00:00,8,3,5,125,33,92,61,40,21,57,51
03-10-2020 17:00:00,10,4,6,116,60,56,72,43,29,79,47
03-10-2020 18:00:00,15,10,5,135,77,58,56,37,19,86,36
03-10-2020 19:00:00,6,3,3,118,51,67,62,34,28,50,34
03-10-2020 20:00:00,6,3,3,92,49,43,54,34,20,57,39
03-10-2020 21:00:00,4,1,3,63,37,26,38,20,18,33,29
03-10-2020 22:00:00,4,2,2,45,26,19,25,13,12,32,9
03-10-2020 23:00:00,1,1,0,32,23,9,10,5,5,21,7
04-10-2020 00:00:00,4,1,3,24,17,7,8,3,5,10,6
04-10-2020 01:00:00,0,0,0,21,13,8,8,3,5,9,4
04-10-2020 02:00:00,0,0,0,13,11,2,2,1,1,7,1
04-10-2020 03:00:00,0,0,0,3,2,1,2,1,1,4,0
04-10-2020 04:00:00,0,0,0,5,2,3,0,0,0,3,3
04-10-2020 05:00:00,1,0,1,3,0,3,0,0,0,1,3
04-10-2020 06:00:00,1,1,0,17,6,11,11,10,1,5,10
04-10-2020 07:00:00,0,0,0,27,7,20,14,13,1,6,10
04-10-2020 08:00:00,2,1,1,27,5,22,13,5,8,12,7
04-10-2020 09:00:00,2,1,1,30,12,18,17,15,2,4,8
04-10-2020 10:00:00,1,1,0,23,8,15,11,10,1,6,12
04-10-2020 11:00:00,3,2,1,39,14,25,20,14,6,7,1
04-10-2020 12:00:00,4,2,2,56,23,33,22,16,6,14,12
04-10-2020 13:00:00,3,1,2,40,20,20,13,8,5,20,9
04-10-2020 14:00:00,5,2,3,61,27,34,22,16,6,17,11
04-10-2020 15:00:00,8,3,5,53,34,19,21,10,11,16,14
04-10-2020 16:00:00,4,3,1,42,19,23,23,12,11,19,21
04-10-2020 17:00:00,4,3,1,72,33,39,24,17,7,25,22
04-10-2020 18:00:00,5,4,1,75,35,40,43,29,14,36,24
04-10-2020 19:00:00,5,3,2,80,37,43,31,20,11,28,15
04-10-2020 20:00:00,2,1,1,55,26,29,36,18,18,34,16
04-10-2020 21:00:00,9,1,8,40,31,9,13,5,8,25,12
04-10-2020 22:00:00,4,0,4,29,21,8,11,4,7,16,5
04-10-2020 23:00:00,0,0,0,16,10,6,9,4,5,8,1
05-10-2020 00:00:00,1,0,1,4,1,3,1,0,1,1,0
05-10-2020 01:00:00,1,0,1,2,0,2,1,0,1,3,4
05-10-2020 02:00:00,0,0,0,3,2,1,0,0,0,3,0
05-10-2020 03:00:00,1,1,0,1,1,0,0,0,0,1,0
05-10-2020 04:00:00,0,0,0,6,2,4,1,1,0,2,3
05-10-2020 05:00:00,1,1,0,29,4,25,10,9,1,4,19
05-10-2020 06:00:00,5,5,0,73,15,58,68,59,9,15,53
05-10-2020 07:00:00,15,12,3,176,38,138,80,72,8,22,92
05-10-2020 08:00:00,24,17,7,246,61,185,127,117,10,41,179
05-10-2020 09:00:00,10,5,5,124,32,92,84,67,17,13,94
05-10-2020 10:00:00,4,2,2,71,17,54,39,33,6,26,33
05-10-2020 11:00:00,15,8,7,68,24,44,46,29,17,25,35
05-10-2020 12:00:00,6,3,3,102,38,64,45,30,15,44,44
05-10-2020 13:00:00,9,6,3,110,42,68,59,39,20,42,46
05-10-2020 14:00:00,13,6,7,99,43,56,53,31,22,68,24
05-10-2020 15:00:00,14,7,7,130,55,75,52,20,32,65,43
05-10-2020 16:00:00,12,4,8,155,88,67,79,35,44,137,36
05-10-2020 17:00:00,23,16,7,269,164,105,141,61,80,166,68
05-10-2020 18:00:00,10,3,7,224,129,95,106,36,70,154,45
05-10-2020 19:00:00,11,4,7,140,77,63,58,28,30,77,28
05-10-2020 20:00:00,8,3,5,107,54,53,47,27,20,47,24
05-10-2020 21:00:00,8,3,5,72,51,21,29,15,14,36,24
05-10-2020 22:00:00,4,2,2,38,20,18,17,8,9,30,4
05-10-2020 23:00:00,2,2,0,19,11,8,11,5,6,16,2
06-10-2020 00:00:00,0,0,0,13,7,6,5,3,2,1,2
06-10-2020 01:00:00,0,0,0,6,4,2,2,1,1,0,1
06-10-2020 02:00:00,0,0,0,2,2,0,0,0,0,2,2
06-10-2020 03:00:00,0,0,0,4,3,1,1,1,0,1,0
06-10-2020 04:00:00,0,0,0,8,2,6,0,0,0,2,3
06-10-2020 05:00:00,3,3,0,32,3,29,11,10,1,4,15
06-10-2020 06:00:00,7,6,1,98,16,82,76,70,6,15,67
06-10-2020 07:00:00,13,10,3,188,50,138,107,94,13,27,121
06-10-2020 08:00:00,22,16,6,259,59,200,148,143,5,36,156
06-10-2020 09:00:00,12,7,5,127,21,106,71,58,13,18,65
06-10-2020 10:00:00,3,2,1,75,27,48,25,21,4,13,39
06-10-2020 11:00:00,4,3,1,86,26,60,34,25,9,24,38
06-10-2020 12:00:00,4,2,2,99,43,56,60,33,27,36,38
06-10-2020 13:00:00,11,8,3,110,42,68,62,40,22,63,45
06-10-2020 14:00:00,11,6,5,100,53,47,53,30,23,61,40
06-10-2020 15:00:00,10,6,4,117,65,52,44,21,23,81,40
06-10-2020 16:00:00,20,12,8,178,102,76,78,34,44,131,50
06-10-2020 17:00:00,20,8,12,291,163,128,123,53,70,185,48
06-10-2020 18:00:00,12,5,7,254,145,109,112,53,59,152,45
06-10-2020 19:00:00,6,5,1,156,88,68,64,33,31,84,27
06-10-2020 20:00:00,1,0,1,114,61,53,43,18,25,65,24
06-10-2020 21:00:00,6,2,4,72,45,27,29,15,14,42,14
06-10-2020 22:00:00,3,3,0,47,29,18,25,19,6,27,15
06-10-2020 23:00:00,3,2,1,26,18,8,15,7,8,23,3
07-10-2020 00:00:00,0,0,0,11,8,3,1,0,1,5,3
07-10-2020 01:00:00,0,0,0,4,4,0,1,1,0,3,2
07-10-2020 02:00:00,0,0,0,3,1,2,0,0,0,1,1
07-10-2020 03:00:00,0,0,0,3,1,2,1,1,0,4,1
07-10-2020 04:00:00,0,0,0,7,3,4,1,1,0,0,2
07-10-2020 05:00:00,1,1,0,23,4,19,11,10,1,3,18
07-10-2020 06:00:00,5,5,0,104,16,88,84,73,11,9,68
07-10-2020 07:00:00,18,16,2,224,61,163,132,114,18,30,131
07-10-2020 08:00:00,41,34,7,320,67,253,176,165,11,49,179
07-10-2020 09:00:00,12,7,5,155,38,117,80,63,17,20,79
07-10-2020 10:00:00,9,8,1,71,21,50,48,35,13,23,42
07-10-2020 11:00:00,17,10,7,100,32,68,55,35,20,33,34
07-10-2020 12:00:00,19,10,9,135,54,81,63,40,23,63,48
07-10-2020 13:00:00,9,6,3,135,57,78,62,37,25,54,41
07-10-2020 14:00:00,17,7,10,125,51,74,60,35,25,82,48
07-10-2020 15:00:00,11,5,6,150,71,79,63,28,35,95,44
07-10-2020 16:00:00,17,8,9,180,101,79,87,34,53,153,61
07-10-2020 17:00:00,19,9,10,272,165,107,120,55,65,192,32
07-10-2020 18:00:00,20,11,9,236,133,103,82,35,47,156,44
07-10-2020 19:00:00,3,2,1,133,67,66,58,24,34,82,23
07-10-2020 20:00:00,4,2,2,99,57,42,33,17,16,48,23
07-10-2020 21:00:00,3,2,1,53,33,20,18,5,13,28,15
07-10-2020 22:00:00,1,1,0,40,28,12,11,4,7,29,8
07-10-2020 23:00:00,4,2,2,22,16,6,8,5,3,10,6
08-10-2020 00:00:00,0,0,0,8,2,6,1,1,0,2,1
08-10-2020 01:00:00,1,0,1,1,1,0,1,1,0,2,1
08-10-2020 02:00:00,0,0,0,3,2,1,2,2,0,2,1
08-10-2020 03:00:00,0,0,0,3,2,1,1,1,0,1,1
08-10-2020 04:00:00,0,0,0,6,0,6,0,0,0,1,2
08-10-2020 05:00:00,1,1,0,22,0,22,13,12,1,3,12
08-10-2020 06:00:00,3,3,0,94,14,80,84,78,6,12,73
08-10-2020 07:00:00,12,10,2,208,49,159,115,102,13,22,132
08-10-2020 08:00:00,29,25,4,299,75,224,174,160,14,45,174
08-10-2020 09:00:00,9,7,2,154,38,116,101,76,25,21,92
08-10-2020 10:00:00,12,8,4,100,36,64,39,30,9,16,37
08-10-2020 11:00:00,13,5,8,99,31,68,62,43,19,34,56
08-10-2020 12:00:00,6,4,2,135,58,77,57,34,23,57,60
08-10-2020 13:00:00,16,12,4,151,67,84,62,42,20,76,45
08-10-2020 14:00:00,18,9,9,129,54,75,65,38,27,66,37
08-10-2020 15:00:00,14,6,8,156,93,63,72,34,38,84,54
08-10-2020 16:00:00,25,12,13,201,109,92,107,49,58,136,62
08-10-2020 17:00:00,20,10,10,332,195,137,160,70,90,228,80
08-10-2020 18:00:00,15,8,7,274,154,120,125,53,72,178,66
08-10-2020 19:00:00,13,7,6,178,91,87,79,38,41,98,32
08-10-2020 20:00:00,10,5,5,116,64,52,50,23,27,54,18
08-10-2020 21:00:00,6,4,2,64,40,24,32,11,21,43,18
08-10-2020 22:00:00,6,4,2,64,39,25,21,9,12,31,11
08-10-2020 23:00:00,3,1,2,38,32,6,5,2,3,21,6
09-10-2020 00:00:00,1,0,1,12,6,6,7,2,5,12,3
09-10-2020 01:00:00,1,0,1,6,5,1,3,1,2,6,1
09-10-2020 02:00:00,0,0,0,6,3,3,0,0,0,4,1
09-10-2020 03:00:00,0,0,0,5,3,2,1,1,0,0,1
09-10-2020 04:00:00,0,0,0,14,7,7,3,2,1,3,6
09-10-2020 05:00:00,1,1,0,22,4,18,12,12,0,6,13
09-10-2020 06:00:00,4,4,0,97,15,82,83,77,6,10,64
09-10-2020 07:00:00,13,11,2,211,63,148,113,101,12,32,138
09-10-2020 08:00:00,28,20,8,289,71,218,139,127,12,37,175
09-10-2020 09:00:00,11,5,6,143,35,108,91,72,19,24,79
09-10-2020 10:00:00,9,4,5,95,31,64,53,39,14,23,40
09-10-2020 11:00:00,15,7,8,102,29,73,63,46,17,36,26
09-10-2020 12:00:00,22,15,7,157,61,96,63,38,25,53,53
09-10-2020 13:00:00,15,8,7,174,80,94,80,45,35,84,57
09-10-2020 14:00:00,22,13,9,151,60,91,83,39,44,74,49
09-10-2020 15:00:00,12,4,8,157,76,81,67,34,33,99,54
09-10-2020 16:00:00,11,5,6,206,105,101,94,45,49,113,44
09-10-2020 17:00:00,30,18,12,302,177,125,112,44,68,173,62
09-10-2020 18:00:00,8,3,5,276,133,143,110,58,52,157,56
09-10-2020 19:00:00,12,5,7,197,105,92,76,38,38,86,19
09-10-2020 20:00:00,6,2,4,120,68,52,46,24,22,54,27
09-10-2020 21:00:00,13,4,9,86,54,32,50,19,31,47,30
09-10-2020 22:00:00,6,5,1,56,37,19,26,10,16,28,17
09-10-2020 23:00:00,3,2,1,51,31,20,9,3,6,39,10
10-10-2020 00:00:00,1,0,1,26,15,11,13,7,6,18,6
10-10-2020 01:00:00,1,0,1,17,12,5,3,3,0,8,4
10-10-2020 02:00:00,1,1,0,16,7,9,2,2,0,6,2
10-10-2020 03:00:00,2,0,2,6,3,3,3,3,0,1,1
10-10-2020 04:00:00,0,0,0,7,4,3,1,1,0,4,2
10-10-2020 05:00:00,0,0,0,18,4,14,3,2,1,2,5
10-10-2020 06:00:00,0,0,0,38,4,34,18,15,3,4,21
10-10-2020 07:00:00,4,4,0,61,19,42,44,41,3,10,33
10-10-2020 08:00:00,7,6,1,60,19,41,37,28,9,17,31
10-10-2020 09:00:00,16,11,5,133,46,87,52,38,14,30,43
10-10-2020 10:00:00,10,6,4,126,37,89,76,48,28,49,37
10-10-2020 11:00:00,13,7,6,137,58,79,78,35,43,77,54
10-10-2020 12:00:00,18,12,6,172,70,102,78,44,34,87,62
10-10-2020 13:00:00,22,12,10,183,64,119,94,52,42,85,80
10-10-2020 14:00:00,22,10,12,158,63,95,104,59,45,100,77
10-10-2020 15:00:00,17,11,6,159,68,91,88,49,39,27,68
10-10-2020 16:00:00,15,11,4,126,53,73,77,46,31,87,89
10-10-2020 17:00:00,15,12,3,173,78,95,66,43,23,85,54
10-10-2020 18:00:00,12,8,4,152,83,69,95,65,30,80,58
10-10-2020 19:00:00,15,10,5,133,59,74,53,37,16,50,54
10-10-2020 20:00:00,10,6,4,93,48,45,48,26,22,63,27
10-10-2020 21:00:00,1,0,1,81,50,31,23,14,9,32,16
10-10-2020 22:00:00,3,2,1,52,29,23,30,13,17,33,14
10-10-2020 23:00:00,0,0,0,34,23,11,17,11,6,24,7
11-10-2020 00:00:00,0,0,0,27,16,11,6,4,2,6,8
11-10-2020 01:00:00,1,0,1,15,11,4,3,2,1,6,0
11-10-2020 02:00:00,1,0,1,7,5,2,5,3,2,9,3
11-10-2020 03:00:00,0,0,0,8,3,5,2,1,1,10,1
11-10-2020 04:00:00,0,0,0,7,1,6,2,2,0,2,2
11-10-2020 05:00:00,0,0,0,8,5,3,3,2,1,6,2
11-10-2020 06:00:00,1,1,0,19,4,15,15,14,1,7,11
11-10-2020 07:00:00,3,3,0,26,8,18,19,14,5,17,12
11-10-2020 08:00:00,4,2,2,66,24,42,26,19,7,36,13
11-10-2020 09:00:00,7,6,1,81,25,56,64,34,30,30,36
11-10-2020 10:00:00,10,5,5,113,38,75,67,31,36,44,52
11-10-2020 11:00:00,9,7,2,142,46,96,89,60,29,71,35
11-10-2020 12:00:00,13,6,7,194,64,130,130,82,48,71,53
11-10-2020 13:00:00,17,12,5,180,87,93,152,85,67,80,39
11-10-2020 14:00:00,33,15,18,154,54,100,166,93,73,104,69
11-10-2020 15:00:00,25,17,8,158,73,85,112,48,64,85,58
11-10-2020 16:00:00,20,13,7,130,64,66,83,31,52,89,73
11-10-2020 17:00:00,16,8,8,127,62,65,69,37,32,61,79
11-10-2020 18:00:00,18,4,14,146,76,70,77,35,42,56,45
11-10-2020 19:00:00,10,7,3,114,52,62,60,33,27,48,39
11-10-2020 20:00:00,8,1,7,83,45,38,43,16,27,51,23
11-10-2020 21:00:00,4,3,1,55,41,14,30,14,16,35,16
11-10-2020 22:00:00,2,0,2,39,27,12,32,7,25,24,3
11-10-2020 23:00:00,4,2,2,24,19,5,11,4,7,12,4
12-10-2020 00:00:00,2,0,2,10,8,2,3,3,0,7,3
12-10-2020 01:00:00,0,0,0,5,2,3,2,1,1,2,0
12-10-2020 02:00:00,0,0,0,2,2,0,1,1,0,4,1
12-10-2020 03:00:00,0,0,0,3,2,1,1,1,0,3,2
12-10-2020 04:00:00,0,0,0,6,3,3,0,0,0,2,4
12-10-2020 05:00:00,1,1,0,30,1,29,16,15,1,5,13
12-10-2020 06:00:00,6,6,0,80,11,69,81,73,8,15,59
12-10-2020 07:00:00,19,16,3,195,55,140,107,94,13,26,130
12-10-2020 08:00:00,24,19,5,285,65,220,166,145,21,42,157
12-10-2020 09:00:00,17,11,6,147,37,110,69,60,9,15,54
12-10-2020 10:00:00,7,3,4,76,23,53,40,32,8,25,40
12-10-2020 11:00:00,9,5,4,63,21,42,42,32,10,35,34
12-10-2020 12:00:00,13,4,9,122,52,70,54,31,23,62,37
12-10-2020 13:00:00,11,5,6,122,42,80,58,37,21,53,57
12-10-2020 14:00:00,15,10,5,102,50,52,58,34,24,71,43
12-10-2020 15:00:00,13,8,5,103,47,56,63,24,39,80,50
12-10-2020 16:00:00,23,13,10,165,102,63,80,34,46,118,42
12-10-2020 17:00:00,17,8,9,282,166,116,158,64,94,193,61
12-10-2020 18:00:00,24,14,10,213,109,104,94,40,54,142,19
12-10-2020 19:00:00,10,2,8,140,79,61,66,26,40,102,26
12-10-2020 20:00:00,4,1,3,119,69,50,35,17,18,51,24
12-10-2020 21:00:00,13,6,7,57,41,16,42,12,30,34,15
12-10-2020 22:00:00,1,0,1,33,20,13,30,14,16,21,5
12-10-2020 23:00:00,0,0,0,17,11,6,7,2,5,12,5
13-10-2020 00:00:00,2,0,2,10,6,4,4,2,2,2,3
13-10-2020 01:00:00,0,0,0,3,1,2,2,1,1,0,0
13-10-2020 02:00:00,0,0,0,4,2,2,0,0,0,1,0
13-10-2020 03:00:00,0,0,0,3,1,2,1,1,0,0,0
13-10-2020 04:00:00,1,0,1,8,3,5,0,0,0,0,3
13-10-2020 05:00:00,1,1,0,31,2,29,13,12,1,4,11
13-10-2020 06:00:00,5,5,0,98,12,86,89,81,8,13,68
13-10-2020 07:00:00,20,16,4,209,62,147,127,106,21,35,132
13-10-2020 08:00:00,33,29,4,351,82,269,178,165,13,39,212
13-10-2020 09:00:00,20,13,7,178,31,147,100,78,22,34,82
13-10-2020 10:00:00,14,8,6,76,32,44,43,31,12,27,62
13-10-2020 11:00:00,8,3,5,85,29,56,55,37,18,31,40
13-10-2020 12:00:00,11,8,3,134,54,80,77,40,37,61,45
13-10-2020 13:00:00,6,2,4,131,64,67,105,67,38,71,61
13-10-2020 14:00:00,16,11,5,127,61,66,94,57,37,64,38
13-10-2020 15:00:00,16,9,7,141,76,65,93,43,50,102,38
13-10-2020 16:00:00,20,8,12,189,111,78,154,65,89,163,52
13-10-2020 17:00:00,29,16,13,315,196,119,197,82,115,185,58
13-10-2020 18:00:00,16,8,8,243,155,88,116,47,69,175,31
13-10-2020 19:00:00,1,1,0,156,81,75,78,38,40,57,26
13-10-2020 20:00:00,7,1,6,97,52,45,36,14,22,56,22
13-10-2020 21:00:00,7,3,4,53,32,21,25,8,17,28,11
13-10-2020 22:00:00,0,0,0,41,32,9,29,16,13,26,11
13-10-2020 23:00:00,1,0,1,25,17,8,12,4,8,20,7
14-10-2020 00:00:00,1,0,1,12,6,6,9,4,5,2,1
14-10-2020 01:00:00,1,0,1,9,5,4,2,2,0,1,3
14-10-2020 02:00:00,0,0,0,0,0,0,0,0,0,0,0
14-10-2020 03:00:00,0,0,0,2,2,0,1,1,0,0,0
14-10-2020 04:00:00,0,0,0,9,3,6,0,0,0,0,2
14-10-2020 05:00:00,2,2,0,29,2,27,15,14,1,5,15
14-10-2020 06:00:00,8,8,0,115,26,89,89,82,7,14,67
14-10-2020 07:00:00,18,14,4,213,59,154,120,101,19,27,128
14-10-2020 08:00:00,33,25,8,328,75,253,169,155,14,37,142
14-10-2020 09:00:00,7,3,4,168,30,138,75,62,13,16,55
14-10-2020 10:00:00,9,7,2,78,27,51,34,27,7,20,51
14-10-2020 11:00:00,11,6,5,84,25,59,40,28,12,32,42
14-10-2020 12:00:00,14,11,3,127,59,68,75,45,30,64,54
14-10-2020 13:00:00,9,7,2,152,67,85,61,43,18,63,48
14-10-2020 14:00:00,14,7,7,136,65,71,78,50,28,68,55
14-10-2020 15:00:00,24,13,11,153,73,80,81,41,40,93,49
14-10-2020 16:00:00,13,3,10,182,95,87,115,50,65,128,43
14-10-2020 17:00:00,29,13,16,333,219,114,151,61,90,207,56
14-10-2020 18:00:00,15,3,12,240,130,110,123,49,74,162,56
14-10-2020 19:00:00,4,1,3,176,94,82,67,34,33,100,39
14-10-2020 20:00:00,15,8,7,131,72,59,40,20,20,67,31
14-10-2020 21:00:00,7,3,4,76,44,32,36,16,20,32,23
14-10-2020 22:00:00,3,1,2,50,31,19,14,5,9,39,19
14-10-2020 23:00:00,1,1,0,28,19,9,10,6,4,17,7
15-10-2020 00:00:00,1,1,0,22,11,11,1,1,0,12,1
15-10-2020 01:00:00,0,0,0,5,3,2,2,1,1,2,1
15-10-2020 02:00:00,0,0,0,2,2,0,0,0,0,6,0
15-10-2020 03:00:00,0,0,0,4,3,1,1,1,0,3,0
15-10-2020 04:00:00,0,0,0,5,0,5,0,0,0,2,3
15-10-2020 05:00:00,2,2,0,25,3,22,13,12,1,3,11
15-10-2020 06:00:00,10,8,2,97,12,85,85,75,10,16,65
15-10-2020 07:00:00,16,14,2,204,44,160,132,111,21,23,78
15-10-2020 08:00:00,24,20,4,285,71,214,149,135,14,38,156
15-10-2020 09:00:00,5,4,1,137,29,108,63,47,16,10,59
15-10-2020 10:00:00,5,5,0,79,19,60,60,54,6,13,27
15-10-2020 11:00:00,5,3,2,89,28,61,48,37,11,26,50
15-10-2020 12:00:00,11,6,5,119,46,73,51,38,13,49,43
15-10-2020 13:00:00,18,10,8,160,68,92,65,41,24,70,56
15-10-2020 14:00:00,18,10,8,141,64,77,90,42,48,73,53
15-10-2020 15:00:00,10,7,3,158,77,81,60,28,32,75,50
15-10-2020 16:00:00,13,9,4,181,106,75,109,43,66,143,40
15-10-2020 17:00:00,25,12,13,274,160,114,148,60,88,177,64
15-10-2020 18:00:00,25,15,10,238,145,93,130,55,75,186,33
15-10-2020 19:00:00,8,6,2,181,84,97,76,40,36,103,48
15-10-2020 20:00:00,2,0,2,91,50,41,43,18,25,77,24
15-10-2020 21:00:00,2,1,1,57,39,18,36,15,21,48,11
15-10-2020 22:00:00,4,3,1,74,44,30,32,17,15,27,11
15-10-2020 23:00:00,1,1,0,32,23,9,10,4,6,24,8
16-10-2020 00:00:00,1,1,0,15,11,4,5,2,3,16,2
16-10-2020 01:00:00,0,0,0,5,3,2,3,2,1,3,1
16-10-2020 02:00:00,0,0,0,2,2,0,0,0,0,3,3
16-10-2020 03:00:00,0,0,0,2,1,1,1,1,0,4,1
16-10-2020 04:00:00,0,0,0,7,5,2,3,2,1,2,3
16-10-2020 05:00:00,2,2,0,23,2,21,16,16,0,4,16
16-10-2020 06:00:00,6,6,0,102,18,84,83,80,3,9,55
16-10-2020 07:00:00,10,7,3,192,51,141,126,107,19,31,143
16-10-2020 08:00:00,33,24,9,283,86,197,153,132,21,43,153
16-10-2020 09:00:00,13,7,6,149,30,119,117,99,18,31,97
16-10-2020 10:00:00,14,10,4,89,28,61,58,34,24,30,51
16-10-2020 11:00:00,17,10,7,91,30,61,56,38,18,30,43
16-10-2020 12:00:00,14,5,9,147,58,89,63,44,19,48,50
16-10-2020 13:00:00,12,9,3,125,53,72,79,46,33,82,59
16-10-2020 14:00:00,14,6,8,166,81,85,93,50,43,77,53
16-10-2020 15:00:00,16,6,10,166,81,85,86,39,47,92,39
16-10-2020 16:00:00,11,8,3,198,103,95,89,37,52,111,58
16-10-2020 17:00:00,27,11,16,285,153,132,143,59,84,199,69
16-10-2020 18:00:00,20,9,11,215,123,92,112,51,61,177,38
16-10-2020 19:00:00,6,1,5,177,89,88,84,50,34,88,46
16-10-2020 20:00:00,13,10,3,129,73,56,50,29,21,59,32
16-10-2020 21:00:00,6,2,4,89,48,41,43,27,16,62,24
16-10-2020 22:00:00,3,0,3,65,49,16,32,12,20,38,12
16-10-2020 23:00:00,7,4,3,41,26,15,13,7,6,25,7
17-10-2020 00:00:00,1,1,0,32,21,11,10,6,4,19,5
17-10-2020 01:00:00,0,0,0,18,13,5,9,5,4,6,1
17-10-2020 02:00:00,2,2,0,8,7,1,3,1,2,5,2
17-10-2020 03:00:00,0,0,0,6,1,5,0,0,0,4,3
17-10-2020 04:00:00,0,0,0,8,3,5,2,1,1,3,2
17-10-2020 05:00:00,0,0,0,11,3,8,1,1,0,2,3
17-10-2020 06:00:00,1,1,0,34,6,28,22,21,1,9,24
17-10-2020 07:00:00,4,2,2,55,8,47,47,42,5,12,37
17-10-2020 08:00:00,2,1,1,72,25,47,35,29,6,20,23
17-10-2020 09:00:00,8,5,3,108,40,68,61,40,21,33,39
17-10-2020 10:00:00,18,15,3,116,48,68,73,45,28,55,60
17-10-2020 11:00:00,23,12,11,111,37,74,91,69,22,61,50
17-10-2020 12:00:00,23,11,12,164,70,94,119,73,46,83,67
17-10-2020 13:00:00,20,10,10,150,61,89,108,66,42,92,39
17-10-2020 14:00:00,21,17,4,170,73,97,87,43,44,83,37
17-10-2020 15:00:00,17,3,14,129,61,68,81,33,48,78,56
17-10-2020 16:00:00,11,5,6,138,72,66,82,50,32,75,59
17-10-2020 17:00:00,8,2,6,134,55,79,72,40,32,76,52
17-10-2020 18:00:00,14,10,4,147,67,80,51,28,23,96,44
17-10-2020 19:00:00,15,7,8,132,70,62,51,25,26,56,38
17-10-2020 20:00:00,6,5,1,88,48,40,59,38,21,55,39
17-10-2020 21:00:00,5,1,4,67,37,30,27,15,12,46,22
17-10-2020 22:00:00,4,1,3,38,28,10,25,12,13,30,9
17-10-2020 23:00:00,6,5,1,48,34,14,14,5,9,21,8
18-10-2020 00:00:00,3,1,2,28,19,9,7,6,1,16,4
18-10-2020 01:00:00,2,1,1,8,4,4,7,2,5,16,2
18-10-2020 02:00:00,1,1,0,8,5,3,7,4,3,4,0
18-10-2020 03:00:00,0,0,0,4,2,2,3,0,3,5,1
18-10-2020 04:00:00,1,1,0,5,3,2,1,1,0,5,3
18-10-2020 05:00:00,0,0,0,7,3,4,1,1,0,2,3
18-10-2020 06:00:00,0,0,0,28,8,20,10,10,0,15,13
18-10-2020 07:00:00,5,5,0,42,18,24,27,23,4,9,30
18-10-2020 08:00:00,22,3,19,50,14,36,58,22,36,31,32
18-10-2020 09:00:00,10,7,3,72,22,50,73,34,39,50,35
18-10-2020 10:00:00,12,7,5,113,42,71,74,47,27,62,43
18-10-2020 11:00:00,26,16,10,150,39,111,99,61,38,75,50
18-10-2020 12:00:00,26,18,8,188,76,112,116,86,30,75,69
18-10-2020 13:00:00,26,14,12,181,79,102,110,68,42,96,69
18-10-2020 14:00:00,23,8,15,160,67,93,113,56,57,62,79
18-10-2020 15:00:00,18,14,4,161,62,99,113,72,41,93,72
18-10-2020 16:00:00,15,10,5,150,74,76,84,44,40,61,78
18-10-2020 17:00:00,11,5,6,137,66,71,84,45,39,85,42
18-10-2020 18:00:00,15,7,8,132,82,50,57,30,27,72,27
18-10-2020 19:00:00,10,4,6,98,61,37,59,40,19,59,25
18-10-2020 20:00:00,5,5,0,75,36,39,35,24,11,40,16
18-10-2020 21:00:00,7,4,3,70,48,22,16,10,6,33,3
18-10-2020 22:00:00,4,3,1,33,23,10,24,11,13,24,11
18-10-2020 23:00:00,0,0,0,17,16,1,11,8,3,12,4
19-10-2020 00:00:00,1,1,0,14,9,5,1,1,0,5,0
19-10-2020 01:00:00,1,0,1,1,1,0,1,0,1,1,0
19-10-2020 02:00:00,1,0,1,2,0,2,0,0,0,1,2
19-10-2020 03:00:00,0,0,0,3,1,2,3,1,2,4,2
19-10-2020 04:00:00,0,0,0,10,4,6,2,1,1,1,1
19-10-2020 05:00:00,2,2,0,25,2,23,18,18,0,5,19
19-10-2020 06:00:00,7,6,1,81,9,72,75,68,7,9,57
19-10-2020 07:00:00,9,7,2,183,50,133,94,83,11,27,109
19-10-2020 08:00:00,24,20,4,280,66,214,142,126,16,46,113
19-10-2020 09:00:00,13,7,6,134,26,108,63,56,7,22,65
19-10-2020 10:00:00,2,1,1,63,19,44,37,27,10,10,21
19-10-2020 11:00:00,4,2,2,81,25,56,40,27,13,20,28
19-10-2020 12:00:00,6,5,1,96,42,54,36,23,13,31,28
19-10-2020 13:00:00,10,8,2,95,41,54,45,30,15,34,18
19-10-2020 14:00:00,6,3,3,86,34,52,44,28,16,46,19
19-10-2020 15:00:00,5,1,4,88,55,33,49,22,27,53,36
19-10-2020 16:00:00,16,8,8,167,92,75,68,31,37,81,27
19-10-2020 17:00:00,17,7,10,239,152,87,115,49,66,146,33
19-10-2020 18:00:00,15,6,9,184,113,71,75,32,43,136,14
19-10-2020 19:00:00,8,2,6,105,62,43,48,24,24,70,21
19-10-2020 20:00:00,7,4,3,79,47,32,35,17,18,51,16
19-10-2020 21:00:00,5,1,4,46,29,17,28,14,14,28,12
19-10-2020 22:00:00,0,0,0,30,22,8,20,6,14,17,1
19-10-2020 23:00:00,1,1,0,17,14,3,8,5,3,7,1
20-10-2020 00:00:00,0,0,0,6,2,4,4,3,1,6,3
20-10-2020 01:00:00,0,0,0,2,2,0,2,2,0,3,0
20-10-2020 02:00:00,0,0,0,0,0,0,0,0,0,1,4
20-10-2020 03:00:00,0,0,0,2,1,1,0,0,0,1,1
20-10-2020 04:00:00,0,0,0,9,3,6,4,3,1,1,2
20-10-2020 05:00:00,2,1,1,32,4,28,12,12,0,4,14
20-10-2020 06:00:00,6,6,0,78,8,70,73,70,3,15,59
20-10-2020 07:00:00,12,9,3,189,43,146,102,88,14,33,88
20-10-2020 08:00:00,32,22,10,290,74,216,143,129,14,34,145
20-10-2020 09:00:00,12,8,4,125,23,102,48,37,11,18,44
20-10-2020 10:00:00,5,5,0,51,16,35,30,28,2,10,37
20-10-2020 11:00:00,10,8,2,71,17,54,31,22,9,19,29
20-10-2020 12:00:00,9,6,3,85,34,51,54,35,19,49,45
20-10-2020 13:00:00,14,9,5,115,51,64,49,36,13,36,30
20-10-2020 14:00:00,9,4,5,87,39,48,62,33,29,58,32
20-10-2020 15:00:00,16,10,6,134,73,61,61,32,29,80,47
20-10-2020 16:00:00,26,13,13,117,99,18,56,27,29,110,33
20-10-2020 17:00:00,17,10,7,223,160,63,131,57,74,164,56
20-10-2020 18:00:00,15,7,8,216,122,94,100,40,60,133,23
20-10-2020 19:00:00,11,6,5,181,95,86,52,21,31,67,25
20-10-2020 20:00:00,5,3,2,96,52,44,37,15,22,45,30
20-10-2020 21:00:00,5,2,3,57,34,23,43,21,22,40,20
20-10-2020 22:00:00,4,0,4,67,40,27,19,15,4,25,9
20-10-2020 23:00:00,0,0,0,31,26,5,10,5,5,10,3
21-10-2020 00:00:00,1,1,0,10,6,4,2,2,0,9,3
21-10-2020 01:00:00,0,0,0,8,6,2,2,2,0,5,2
21-10-2020 02:00:00,0,0,0,0,0,0,1,0,1,4,1
21-10-2020 03:00:00,0,0,0,3,1,2,2,2,0,3,1
21-10-2020 04:00:00,0,0,0,8,3,5,1,0,1,1,6
21-10-2020 05:00:00,1,1,0,24,3,21,20,19,1,1,18
21-10-2020 06:00:00,4,4,0,95,13,82,87,83,4,13,79
21-10-2020 07:00:00,10,9,1,209,52,157,114,96,18,34,125
21-10-2020 08:00:00,30,21,9,303,68,235,152,139,13,34,141
21-10-2020 09:00:00,16,10,6,162,36,126,103,83,20,25,91
21-10-2020 10:00:00,8,2,6,96,34,62,56,36,20,28,56
21-10-2020 11:00:00,11,8,3,93,30,63,50,31,19,39,61
21-10-2020 12:00:00,17,10,7,139,44,95,57,41,16,54,60
21-10-2020 13:00:00,9,9,0,162,64,98,73,48,25,78,62
21-10-2020 14:00:00,21,10,11,129,59,70,69,43,26,70,27
21-10-2020 15:00:00,14,10,4,159,75,84,71,34,37,85,53
21-10-2020 16:00:00,20,13,7,186,102,84,102,44,58,151,51
21-10-2020 17:00:00,27,16,11,280,168,112,143,61,82,204,78
21-10-2020 18:00:00,16,3,13,280,157,123,114,54,60,164,60
21-10-2020 19:00:00,18,10,8,169,76,93,75,37,38,79,38
21-10-2020 20:00:00,7,4,3,147,67,80,52,27,25,68,23
21-10-2020 21:00:00,6,1,5,49,25,24,40,21,19,49,19
21-10-2020 22:00:00,1,1,0,35,22,13,22,8,14,28,8
21-10-2020 23:00:00,5,1,4,48,38,10,14,7,7,19,5
22-10-2020 00:00:00,1,0,1,10,7,3,6,2,4,9,3
22-10-2020 01:00:00,1,1,0,5,4,1,3,1,2,5,4
22-10-2020 02:00:00,0,0,0,4,3,1,0,0,0,1,3
22-10-2020 03:00:00,0,0,0,4,1,3,2,1,1,2,0
22-10-2020 04:00:00,0,0,0,6,1,5,1,0,1,2,1
22-10-2020 05:00:00,1,1,0,25,1,24,9,7,2,3,11
22-10-2020 06:00:00,3,3,0,88,11,77,85,76,9,13,61
22-10-2020 07:00:00,13,12,1,192,53,139,99,87,12,36,104
22-10-2020 08:00:00,24,19,5,285,87,198,131,118,13,42,147
22-10-2020 09:00:00,12,8,4,107,26,81,85,70,15,19,59
22-10-2020 10:00:00,4,2,2,80,26,54,28,20,8,20,38
22-10-2020 11:00:00,11,7,4,126,39,87,50,35,15,37,42
22-10-2020 12:00:00,8,3,5,114,47,67,66,33,33,55,46
22-10-2020 13:00:00,8,5,3,131,59,72,67,40,27,45,42
22-10-2020 14:00:00,16,6,10,121,54,67,71,40,31,57,38
22-10-2020 15:00:00,13,7,6,135,67,68,94,45,49,76,37
22-10-2020 16:00:00,27,14,13,177,104,73,109,43,66,105,47
22-10-2020 17:00:00,23,12,11,253,146,107,141,72,69,174,53
22-10-2020 18:00:00,19,6,13,220,136,84,122,51,71,170,51
22-10-2020 19:00:00,7,5,2,147,77,70,74,33,41,91,26
22-10-2020 20:00:00,5,2,3,92,55,37,31,15,16,34,7
22-10-2020 21:00:00,2,0,2,46,36,10,36,12,24,31,11
22-10-2020 22:00:00,2,1,1,36,23,13,14,9,5,26,3
22-10-2020 23:00:00,0,0,0,21,15,6,4,1,3,12,4
23-10-2020 00:00:00,1,0,1,10,7,3,4,3,1,5,0
23-10-2020 01:00:00,0,0,0,1,0,1,3,1,2,2,1
23-10-2020 02:00:00,1,0,1,0,0,0,1,1,0,2,1
23-10-2020 03:00:00,0,0,0,2,1,1,1,1,0,2,0
23-10-2020 04:00:00,0,0,0,10,5,5,1,0,1,1,4
23-10-2020 05:00:00,1,1,0,23,5,18,9,8,1,3,9
23-10-2020 06:00:00,2,2,0,83,13,70,67,61,6,12,59
23-10-2020 07:00:00,7,7,0,141,39,102,87,70,17,26,91
23-10-2020 08:00:00,19,15,4,232,70,162,118,109,9,33,116
23-10-2020 09:00:00,16,10,6,120,30,90,78,61,17,20,57
23-10-2020 10:00:00,7,4,3,82,25,57,53,36,17,13,40
23-10-2020 11:00:00,12,7,5,90,29,61,69,48,21,29,29
23-10-2020 12:00:00,17,8,9,118,56,62,66,44,22,41,39
23-10-2020 13:00:00,14,8,6,144,56,88,74,44,30,54,27
23-10-2020 14:00:00,8,4,4,149,80,69,74,34,40,82,41
23-10-2020 15:00:00,16,9,7,158,82,76,80,39,41,71,39
23-10-2020 16:00:00,25,11,14,185,95,90,90,43,47,103,50
23-10-2020 17:00:00,10,6,4,216,116,100,91,37,54,141,23
23-10-2020 18:00:00,17,8,9,209,120,89,119,64,55,121,50
23-10-2020 19:00:00,14,5,9,158,85,73,73,43,30,69,35
23-10-2020 20:00:00,8,6,2,105,48,57,62,29,33,55,33
23-10-2020 21:00:00,3,2,1,64,41,23,49,19,30,42,25
23-10-2020 22:00:00,3,3,0,51,31,20,21,12,9,29,13
23-10-2020 23:00:00,1,0,1,30,23,7,14,4,10,11,8
24-10-2020 00:00:00,0,0,0,19,8,11,3,1,2,9,3
24-10-2020 01:00:00,0,0,0,10,7,3,3,3,0,2,3
24-10-2020 02:00:00,0,0,0,3,3,0,0,0,0,1,5
24-10-2020 03:00:00,0,0,0,6,3,3,0,0,0,0,0
24-10-2020 04:00:00,0,0,0,4,1,3,0,0,0,0,5
24-10-2020 05:00:00,1,1,0,11,4,7,4,3,1,2,4
24-10-2020 06:00:00,1,1,0,26,3,23,10,8,2,10,16
24-10-2020 07:00:00,2,1,1,33,5,28,18,15,3,7,19
24-10-2020 08:00:00,2,2,0,42,19,23,20,15,5,12,20
24-10-2020 09:00:00,6,6,0,52,23,29,18,13,5,19,12
24-10-2020 10:00:00,9,2,7,55,15,40,33,22,11,14,25
24-10-2020 11:00:00,13,8,5,99,43,56,47,29,18,44,49
24-10-2020 12:00:00,10,5,5,117,52,65,65,40,25,58,35
24-10-2020 13:00:00,31,19,12,116,48,68,112,74,38,64,46
24-10-2020 14:00:00,14,6,8,140,57,83,81,55,26,65,55
24-10-2020 15:00:00,15,13,2,138,54,84,82,47,35,70,40
24-10-2020 16:00:00,15,12,3,122,53,69,74,39,35,53,36
24-10-2020 17:00:00,9,7,2,129,70,59,58,35,23,44,35
24-10-2020 18:00:00,7,1,6,134,77,57,60,35,25,59,21
24-10-2020 19:00:00,6,4,2,104,60,44,62,41,21,52,18
24-10-2020 20:00:00,14,13,1,98,56,42,58,33,25,40,27
24-10-2020 21:00:00,3,2,1,53,33,20,27,13,14,41,12
24-10-2020 22:00:00,2,2,0,51,35,16,22,11,11,19,5
24-10-2020 23:00:00,5,4,1,34,25,9,23,14,9,17,8
25-10-2020 00:00:00,0,0,0,14,8,6,4,2,2,9,5
25-10-2020 01:00:00,0,0,0,8,6,2,5,5,0,4,2
25-10-2020 02:00:00,0,0,0,3,1,2,3,0,3,2,2
25-10-2020 03:00:00,0,0,0,2,2,0,2,2,0,1,4
25-10-2020 04:00:00,0,0,0,5,3,2,1,1,0,1,1
25-10-2020 05:00:00,0,0,0,3,1,2,3,2,1,2,2
25-10-2020 06:00:00,1,1,0,24,2,22,7,7,0,8,10
25-10-2020 07:00:00,1,1,0,35,8,27,24,21,3,9,13
25-10-2020 08:00:00,6,3,3,62,31,31,29,21,8,30,11
25-10-2020 09:00:00,18,9,9,119,52,67,56,40,16,24,16
25-10-2020 10:00:00,16,11,5,147,59,88,70,47,23,46,45
25-10-2020 11:00:00,12,6,6,180,60,120,113,65,48,62,51
25-10-2020 12:00:00,27,13,14,206,84,122,138,81,57,62,65
25-10-2020 13:00:00,26,8,18,195,83,112,138,74,64,82,64
25-10-2020 14:00:00,29,18,11,184,83,101,144,76,68,99,83
25-10-2020 15:00:00,29,15,14,171,83,88,131,58,73,83,79
25-10-2020 16:00:00,20,7,13,165,96,69,102,45,57,72,85
25-10-2020 17:00:00,12,11,1,147,83,64,78,34,44,73,46
25-10-2020 18:00:00,8,2,6,119,60,59,68,39,29,48,16
25-10-2020 19:00:00,5,5,0,82,44,38,60,39,21,53,21
25-10-2020 20:00:00,4,0,4,57,30,27,28,16,12,31,25
25-10-2020 21:00:00,1,0,1,54,34,20,35,26,9,35,15
25-10-2020 22:00:00,0,0,0,26,19,7,13,9,4,15,5
25-10-2020 23:00:00,2,2,0,23,18,5,10,6,4,10,4
26-10-2020 00:00:00,0,0,0,7,4,3,4,2,2,4,4
26-10-2020 01:00:00,0,0,0,6,4,2,2,1,1,3,3
26-10-2020 02:00:00,0,0,0,3,1,2,2,1,1,3,1
26-10-2020 03:00:00,0,0,0,4,3,1,1,0,1,1,1
26-10-2020 04:00:00,0,0,0,0,0,0,0,0,0,0,0
26-10-2020 05:00:00,0,0,0,8,2,6,2,2,0,1,5
26-10-2020 06:00:00,2,2,0,19,4,15,15,12,3,15,9
26-10-2020 07:00:00,3,2,1,33,12,21,25,23,2,10,17
26-10-2020 08:00:00,0,0,0,58,21,37,28,23,5,18,27
26-10-2020 09:00:00,16,11,5,77,22,55,36,27,9,24,17
26-10-2020 10:00:00,25,17,8,98,35,63,88,69,19,35,32
26-10-2020 11:00:00,10,7,3,125,48,77,81,56,25,45,42
26-10-2020 12:00:00,11,6,5,128,58,70,71,46,25,71,55
26-10-2020 13:00:00,18,9,9,120,48,72,96,58,38,88,55
26-10-2020 14:00:00,16,8,8,145,67,78,103,49,54,71,50
26-10-2020 15:00:00,12,7,5,106,48,58,88,56,32,53,56
26-10-2020 16:00:00,22,15,7,130,56,74,79,39,40,59,38
26-10-2020 17:00:00,12,8,4,118,55,63,70,39,31,75,37
26-10-2020 18:00:00,6,2,4,106,59,47,60,34,26,49,34
26-10-2020 19:00:00,3,1,2,83,45,38,40,23,17,39,16
26-10-2020 20:00:00,5,0,5,68,36,32,28,15,13,45,27
26-10-2020 21:00:00,3,3,0,31,19,12,17,8,9,21,12
26-10-2020 22:00:00,1,0,1,24,18,6,18,12,6,20,4
26-10-2020 23:00:00,2,1,1,12,8,4,6,3,3,14,7
27-10-2020 00:00:00,1,1,0,4,2,2,3,3,0,2,3
27-10-2020 01:00:00,0,0,0,3,3,0,2,1,1,3,1
27-10-2020 02:00:00,0,0,0,1,0,1,0,0,0,1,1
27-10-2020 03:00:00,0,0,0,2,2,0,1,1,0,1,0
27-10-2020 04:00:00,0,0,0,9,3,6,2,1,1,0,5
27-10-2020 05:00:00,1,1,0,22,2,20,8,8,0,4,12
27-10-2020 06:00:00,4,4,0,66,10,56,95,87,8,12,55
27-10-2020 07:00:00,15,14,1,183,53,130,88,78,10,23,88
27-10-2020 08:00:00,10,7,3,194,60,134,109,92,17,37,120
27-10-2020 09:00:00,6,5,1,85,20,65,56,47,9,16,78
27-10-2020 10:00:00,6,5,1,59,14,45,17,12,5,12,35
27-10-2020 11:00:00,9,7,2,76,32,44,44,33,11,29,37
27-10-2020 12:00:00,7,5,2,108,49,59,59,38,21,38,47
27-10-2020 13:00:00,7,5,2,110,57,53,62,36,26,44,28
27-10-2020 14:00:00,17,5,12,109,52,57,70,35,35,44,28
27-10-2020 15:00:00,6,4,2,93,44,49,65,27,38,73,39
27-10-2020 16:00:00,23,13,10,135,68,67,77,37,40,95,31
27-10-2020 17:00:00,15,7,8,251,137,114,114,51,63,167,38
27-10-2020 18:00:00,7,3,4,185,95,90,94,40,54,105,29
27-10-2020 19:00:00,5,2,3,89,51,38,48,19,29,77,11
27-10-2020 20:00:00,3,2,1,59,36,23,33,15,18,33,16
27-10-2020 21:00:00,1,0,1,22,14,8,19,9,10,14,7
27-10-2020 22:00:00,1,0,1,21,13,8,11,7,4,18,3
27-10-2020 23:00:00,2,2,0,23,15,8,11,6,5,8,2
28-10-2020 00:00:00,0,0,0,6,3,3,2,0,2,4,3
28-10-2020 01:00:00,1,1,0,4,2,2,2,2,0,0,1
28-10-2020 02:00:00,0,0,0,1,0,1,1,0,1,2,2
28-10-2020 03:00:00,0,0,0,5,3,2,1,1,0,1,0
28-10-2020 04:00:00,0,0,0,8,4,4,2,2,0,1,2
28-10-2020 05:00:00,2,2,0,19,0,19,13,13,0,2,10
28-10-2020 06:00:00,4,4,0,87,11,76,84,76,8,7,45
28-10-2020 07:00:00,7,7,0,166,53,113,97,86,11,30,116
28-10-2020 08:00:00,15,13,2,219,58,161,103,94,9,37,150
28-10-2020 09:00:00,11,8,3,112,31,81,60,50,10,35,73
28-10-2020 10:00:00,12,8,4,71,23,48,45,37,8,23,40
28-10-2020 11:00:00,15,11,4,83,30,53,58,38,20,31,32
28-10-2020 12:00:00,7,4,3,94,40,54,73,49,24,38,51
28-10-2020 13:00:00,9,4,5,92,42,50,67,39,28,64,35
28-10-2020 14:00:00,6,1,5,81,38,43,53,26,27,36,26
28-10-2020 15:00:00,15,5,10,108,61,47,48,25,23,47,25
28-10-2020 16:00:00,15,7,8,135,70,65,78,30,48,104,56
28-10-2020 17:00:00,16,9,7,239,128,111,102,43,59,126,27
28-10-2020 18:00:00,19,8,11,185,108,77,94,40,54,94,20
28-10-2020 19:00:00,6,2,4,109,63,46,48,29,19,60,25
28-10-2020 20:00:00,2,2,0,74,47,27,31,12,19,43,15
28-10-2020 21:00:00,3,1,2,47,21,26,24,11,13,27,6
28-10-2020 22:00:00,5,1,4,24,17,7,12,8,4,14,6
28-10-2020 23:00:00,1,0,1,19,12,7,10,6,4,14,0
29-10-2020 00:00:00,1,1,0,8,5,3,0,0,0,2,2
29-10-2020 01:00:00,0,0,0,0,0,0,1,1,0,0,2
29-10-2020 02:00:00,0,0,0,1,0,1,0,0,0,2,3
29-10-2020 03:00:00,0,0,0,3,2,1,1,1,0,0,0
29-10-2020 04:00:00,0,0,0,8,1,7,0,0,0,3,3
29-10-2020 05:00:00,0,0,0,24,3,21,10,9,1,1,10
29-10-2020 06:00:00,4,4,0,62,10,52,78,71,7,14,41
29-10-2020 07:00:00,10,9,1,142,32,110,75,65,10,13,68
29-10-2020 08:00:00,10,10,0,161,44,117,74,71,3,17,103
29-10-2020 09:00:00,7,5,2,81,22,59,44,38,6,11,36
29-10-2020 10:00:00,8,5,3,61,24,37,26,20,6,12,15
29-10-2020 11:00:00,7,4,3,73,31,42,32,23,9,20,17
29-10-2020 12:00:00,7,4,3,84,39,45,40,27,13,31,37
29-10-2020 13:00:00,8,4,4,109,41,68,44,32,12,36,32
29-10-2020 14:00:00,9,6,3,80,36,44,43,26,17,40,32
29-10-2020 15:00:00,9,7,2,95,49,46,52,34,18,64,34
29-10-2020 16:00:00,14,5,9,159,81,78,52,25,27,97,39
29-10-2020 17:00:00,10,4,6,218,119,99,75,33,42,116,44
29-10-2020 18:00:00,10,4,6,172,89,83,80,34,46,115,38
29-10-2020 19:00:00,7,4,3,131,70,61,54,34,20,63,22
29-10-2020 20:00:00,5,3,2,83,42,41,36,18,18,40,25
29-10-2020 21:00:00,5,3,2,39,25,14,19,8,11,31,12
29-10-2020 22:00:00,2,1,1,32,24,8,19,10,9,27,11
29-10-2020 23:00:00,2,2,0,22,16,6,5,4,1,4,7
30-10-2020 00:00:00,2,1,1,7,5,2,1,1,0,4,2
30-10-2020 01:00:00,0,0,0,3,1,2,1,1,0,4,4
30-10-2020 02:00:00,0,0,0,5,1,4,0,0,0,1,1
30-10-2020 03:00:00,0,0,0,4,2,2,1,1,0,2,0
30-10-2020 04:00:00,0,0,0,10,5,5,3,2,1,1,6
30-10-2020 05:00:00,1,1,0,22,0,22,10,9,1,2,10
30-10-2020 06:00:00,3,3,0,81,10,71,78,72,6,17,50
30-10-2020 07:00:00,10,9,1,158,45,113,96,80,16,17,89
30-10-2020 08:00:00,15,13,2,194,52,142,85,78,7,28,109
30-10-2020 09:00:00,7,6,1,111,31,80,58,46,12,17,66
30-10-2020 10:00:00,4,1,3,100,30,70,60,34,26,37,52
30-10-2020 11:00:00,11,6,5,119,42,77,68,42,26,38,30
30-10-2020 12:00:00,15,6,9,139,60,79,76,41,35,69,76
30-10-2020 13:00:00,13,9,4,157,66,91,88,48,40,81,65
30-10-2020 14:00:00,14,6,8,139,66,73,66,38,28,87,65
30-10-2020 15:00:00,12,8,4,166,75,91,123,71,52,95,70
30-10-2020 16:00:00,14,7,7,190,91,99,97,47,50,115,57
30-10-2020 17:00:00,14,5,9,265,142,123,119,62,57,153,42
30-10-2020 18:00:00,10,6,4,202,114,88,124,56,68,146,58
30-10-2020 19:00:00,7,5,2,144,67,77,71,37,34,101,46
30-10-2020 20:00:00,5,1,4,107,59,48,53,29,24,55,41
30-10-2020 21:00:00,7,7,0,81,45,36,45,24,21,42,16
30-10-2020 22:00:00,1,0,1,53,34,19,30,14,16,34,13
30-10-2020 23:00:00,4,2,2,31,18,13,15,8,7,13,10
31-10-2020 00:00:00,3,2,1,17,10,7,8,3,5,13,0
31-10-2020 01:00:00,0,0,0,6,5,1,2,2,0,6,3
31-10-2020 02:00:00,1,1,0,7,4,3,1,1,0,1,1
31-10-2020 03:00:00,0,0,0,6,5,1,1,0,1,3,0
31-10-2020 04:00:00,0,0,0,7,1,6,1,0,1,0,3
31-10-2020 05:00:00,1,1,0,11,3,8,3,2,1,2,2
31-10-2020 06:00:00,0,0,0,19,1,18,14,13,1,9,15
31-10-2020 07:00:00,1,1,0,41,9,32,20,20,0,4,18
31-10-2020 08:00:00,5,5,0,37,12,25,14,11,3,8,12
31-10-2020 09:00:00,6,5,1,43,14,29,20,19,1,22,16
31-10-2020 10:00:00,6,2,4,57,30,27,27,19,8,14,11
31-10-2020 11:00:00,9,5,4,69,20,49,31,17,14,29,24
31-10-2020 12:00:00,6,3,3,80,34,46,45,33,12,29,22
31-10-2020 13:00:00,16,7,9,105,54,51,46,29,17,53,37
31-10-2020 14:00:00,18,6,12,125,57,68,58,27,31,51,56
31-10-2020 15:00:00,14,8,6,108,59,49,50,25,25,50,17
31-10-2020 16:00:00,14,11,3,109,45,64,50,33,17,44,45
31-10-2020 17:00:00,7,4,3,112,56,56,75,45,30,46,39
31-10-2020 18:00:00,7,6,1,123,67,56,43,30,13,39,28
31-10-2020 19:00:00,6,1,5,85,44,41,27,18,9,52,24
31-10-2020 20:00:00,3,2,1,72,37,35,41,28,13,33,24
31-10-2020 21:00:00,4,1,3,46,20,26,31,13,18,30,20
31-10-2020 22:00:00,5,4,1,36,27,9,21,15,6,21,8
31-10-2020 23:00:00,2,1,1,17,9,8,20,9,11,21,8
01-11-2020 00:00:00,3,2,1,19,10,9,10,3,7,7,5
01-11-2020 01:00:00,0,0,0,16,11,5,3,1,2,2,2
01-11-2020 02:00:00,1,1,0,7,6,1,2,0,2,4,0
01-11-2020 03:00:00,0,0,0,8,4,4,2,0,2,1,3
01-11-2020 04:00:00,0,0,0,7,4,3,0,0,0,2,5
01-11-2020 05:00:00,0,0,0,1,1,0,2,1,1,2,3
01-11-2020 06:00:00,1,1,0,21,5,16,9,8,1,5,8
01-11-2020 07:00:00,2,2,0,21,7,14,19,15,4,11,20
01-11-2020 08:00:00,3,2,1,45,11,34,20,12,8,17,11
01-11-2020 09:00:00,4,3,1,58,27,31,28,16,12,17,18
01-11-2020 10:00:00,9,1,8,60,27,33,50,28,22,24,22
01-11-2020 11:00:00,8,3,5,101,34,67,64,44,20,29,26
01-11-2020 12:00:00,6,4,2,78,32,46,42,24,18,44,39
01-11-2020 13:00:00,8,5,3,87,41,46,48,30,18,31,51
01-11-2020 14:00:00,5,2,3,68,41,27,50,34,16,42,40
01-11-2020 15:00:00,10,5,5,75,37,38,40,23,17,31,23
01-11-2020 16:00:00,5,3,2,75,37,38,27,19,8,35,24
01-11-2020 17:00:00,3,0,3,73,37,36,44,24,20,36,18
01-11-2020 18:00:00,3,1,2,79,39,40,41,24,17,42,21
01-11-2020 19:00:00,2,1,1,73,37,36,26,12,14,42,18
01-11-2020 20:00:00,2,1,1,40,18,22,32,14,18,24,10
01-11-2020 21:00:00,1,1,0,27,17,10,15,7,8,15,5
01-11-2020 22:00:00,1,1,0,25,19,6,8,2,6,14,4
01-11-2020 23:00:00,0,0,0,16,7,9,4,3,1,5,3
02-11-2020 00:00:00,0,0,0,2,0,2,2,1,1,5,2
02-11-2020 01:00:00,0,0,0,0,0,0,1,0,1,2,1
02-11-2020 02:00:00,0,0,0,0,0,0,0,0,0,1,0
02-11-2020 03:00:00,0,0,0,1,0,1,0,0,0,1,1
02-11-2020 04:00:00,0,0,0,7,1,6,0,0,0,1,5
02-11-2020 05:00:00,1,1,0,25,5,20,8,7,1,3,17
02-11-2020 06:00:00,3,3,0,73,16,57,92,86,6,8,81
02-11-2020 07:00:00,8,8,0,198,60,138,98,88,10,18,119
02-11-2020 08:00:00,21,15,6,239,61,178,129,116,13,45,154
02-11-2020 09:00:00,5,1,4,111,30,81,50,43,7,11,48
02-11-2020 10:00:00,9,5,4,67,24,43,30,21,9,11,22
02-11-2020 11:00:00,10,6,4,85,27,58,44,36,8,20,19
02-11-2020 12:00:00,9,3,6,79,38,41,50,35,15,28,30
02-11-2020 13:00:00,7,2,5,94,41,53,50,29,21,32,27
02-11-2020 14:00:00,11,5,6,71,38,33,51,23,28,48,28
02-11-2020 15:00:00,12,8,4,76,50,26,41,18,23,61,32
02-11-2020 16:00:00,15,7,8,156,81,75,76,34,42,105,25
02-11-2020 17:00:00,12,4,8,193,115,78,101,30,71,151,28
02-11-2020 18:00:00,10,1,9,136,81,55,75,28,47,95,30
02-11-2020 19:00:00,4,3,1,83,48,35,44,22,22,50,12
02-11-2020 20:00:00,3,1,2,45,25,20,20,10,10,33,17
02-11-2020 21:00:00,3,2,1,36,20,16,24,10,14,20,9
02-11-2020 22:00:00,1,1,0,22,17,5,11,5,6,11,4
02-11-2020 23:00:00,2,1,1,9,6,3,5,3,2,5,2
03-11-2020 00:00:00,1,1,0,8,3,5,2,2,0,2,2
03-11-2020 01:00:00,0,0,0,0,0,0,1,1,0,1,1
03-11-2020 02:00:00,0,0,0,3,0,3,0,0,0,2,3
03-11-2020 03:00:00,0,0,0,2,2,0,0,0,0,1,0
03-11-2020 04:00:00,0,0,0,11,3,8,0,0,0,1,3
03-11-2020 05:00:00,2,2,0,22,4,18,9,7,2,1,13
03-11-2020 06:00:00,4,4,0,77,17,60,88,81,7,15,65
03-11-2020 07:00:00,14,11,3,195,55,140,113,98,15,17,121
03-11-2020 08:00:00,30,23,7,269,76,193,141,127,14,35,162
03-11-2020 09:00:00,12,5,7,117,35,82,67,55,12,23,74
03-11-2020 10:00:00,7,3,4,62,15,47,35,20,15,23,45
03-11-2020 11:00:00,11,6,5,97,37,60,46,32,14,28,26
03-11-2020 12:00:00,7,3,4,130,51,79,58,45,13,44,39
03-11-2020 13:00:00,13,9,4,146,61,85,57,36,21,59,54
03-11-2020 14:00:00,16,6,10,123,54,69,72,32,40,53,42
03-11-2020 15:00:00,12,4,8,109,50,59,71,35,36,77,50
03-11-2020 16:00:00,17,9,8,179,90,89,84,33,51,126,35
03-11-2020 17:00:00,16,7,9,279,147,132,127,52,75,152,53
03-11-2020 18:00:00,15,7,8,214,104,110,83,35,48,152,15
03-11-2020 19:00:00,8,4,4,117,72,45,49,21,28,58,6
03-11-2020 20:00:00,1,1,0,68,41,27,42,20,22,36,12
03-11-2020 21:00:00,6,4,2,43,22,21,21,9,12,27,9
03-11-2020 22:00:00,1,0,1,28,18,10,9,4,5,17,9
03-11-2020 23:00:00,2,2,0,31,20,11,9,8,1,13,3
04-11-2020 00:00:00,1,0,1,11,7,4,2,0,2,4,2
04-11-2020 01:00:00,0,0,0,2,0,2,3,2,1,1,0
04-11-2020 02:00:00,0,0,0,4,4,0,0,0,0,1,1
04-11-2020 03:00:00,0,0,0,4,2,2,0,0,0,0,0
04-11-2020 04:00:00,0,0,0,9,2,7,0,0,0,1,3
04-11-2020 05:00:00,1,1,0,22,5,17,11,10,1,5,13
04-11-2020 06:00:00,7,6,1,97,16,81,98,93,5,14,69
04-11-2020 07:00:00,10,8,2,207,55,152,120,99,21,27,121
04-11-2020 08:00:00,32,24,8,269,79,190,137,127,10,47,151
04-11-2020 09:00:00,6,4,2,108,26,82,66,54,12,23,52
04-11-2020 10:00:00,6,2,4,91,29,62,48,35,13,21,36
04-11-2020 11:00:00,13,8,5,97,32,65,53,37,16,20,26
04-11-2020 12:00:00,17,14,3,115,40,75,66,44,22,53,32
04-11-2020 13:00:00,9,4,5,153,62,91,71,32,39,76,35
04-11-2020 14:00:00,9,4,5,127,64,63,59,23,36,63,41
04-11-2020 15:00:00,17,12,5,129,73,56,61,26,35,85,46
04-11-2020 16:00:00,26,13,13,175,92,83,93,43,50,106,42
04-11-2020 17:00:00,11,7,4,240,146,94,125,57,68,172,42
04-11-2020 18:00:00,19,9,10,203,106,97,96,35,61,128,27
04-11-2020 19:00:00,5,2,3,113,64,49,78,42,36,71,17
04-11-2020 20:00:00,1,1,0,93,53,40,37,15,22,46,24
04-11-2020 21:00:00,4,3,1,56,30,26,32,18,14,31,11
04-11-2020 22:00:00,6,4,2,37,28,9,27,10,17,23,5
04-11-2020 23:00:00,3,1,2,23,18,5,9,3,6,10,3
05-11-2020 00:00:00,2,2,0,7,4,3,1,0,1,11,7
05-11-2020 01:00:00,0,0,0,2,2,0,1,1,0,1,0
05-11-2020 02:00:00,0,0,0,0,0,0,1,1,0,2,2
05-11-2020 03:00:00,0,0,0,4,3,1,0,0,0,2,0
05-11-2020 04:00:00,0,0,0,6,0,6,0,0,0,2,2
05-11-2020 05:00:00,0,0,0,26,5,21,8,6,2,3,10
05-11-2020 06:00:00,4,4,0,86,12,74,83,79,4,19,60
05-11-2020 07:00:00,20,15,5,180,53,127,110,92,18,27,105
05-11-2020 08:00:00,23,17,6,280,76,204,143,131,12,40,145
05-11-2020 09:00:00,8,5,3,105,30,75,63,51,12,25,67
05-11-2020 10:00:00,8,5,3,57,25,32,39,27,12,20,35
05-11-2020 11:00:00,9,4,5,96,34,62,38,21,17,15,27
05-11-2020 12:00:00,11,8,3,112,34,78,48,30,18,42,28
05-11-2020 13:00:00,8,5,3,117,55,62,69,44,25,48,47
05-11-2020 14:00:00,12,7,5,110,47,63,59,32,27,64,26
05-11-2020 15:00:00,15,9,6,141,71,70,62,33,29,67,40
05-11-2020 16:00:00,22,10,12,183,106,77,99,42,57,105,37
05-11-2020 17:00:00,14,4,10,253,144,109,125,52,73,165,37
05-11-2020 18:00:00,7,4,3,167,85,82,98,39,59,131,38
05-11-2020 19:00:00,13,8,5,136,70,66,49,33,16,60,26
05-11-2020 20:00:00,5,3,2,104,67,37,41,23,18,43,22
05-11-2020 21:00:00,3,3,0,60,36,24,33,16,17,38,14
05-11-2020 22:00:00,1,0,1,36,20,16,22,10,12,22,16
05-11-2020 23:00:00,0,0,0,22,16,6,13,5,8,15,4
06-11-2020 00:00:00,1,0,1,9,5,4,7,1,6,4,4
06-11-2020 01:00:00,0,0,0,7,3,4,2,2,0,0,0
06-11-2020 02:00:00,0,0,0,6,4,2,1,1,0,2,1
06-11-2020 03:00:00,1,1,0,5,1,4,0,0,0,5,0
06-11-2020 04:00:00,0,0,0,10,4,6,2,1,1,0,4
06-11-2020 05:00:00,0,0,0,24,3,21,10,8,2,3,15
06-11-2020 06:00:00,5,4,1,85,19,66,90,83,7,16,65
06-11-2020 07:00:00,12,10,2,182,50,132,104,92,12,30,113
06-11-2020 08:00:00,25,20,5,255,74,181,150,133,17,40,152
06-11-2020 09:00:00,14,9,5,129,33,96,72,57,15,32,61
06-11-2020 10:00:00,11,7,4,85,31,54,45,30,15,11,37
06-11-2020 11:00:00,7,7,0,119,38,81,56,37,19,20,42
06-11-2020 12:00:00,8,5,3,142,66,76,78,54,24,61,42
06-11-2020 13:00:00,12,8,4,163,75,88,83,48,35,64,57
06-11-2020 14:00:00,14,11,3,141,63,78,95,60,35,83,68
06-11-2020 15:00:00,15,8,7,182,86,96,99,44,55,103,52
06-11-2020 16:00:00,20,9,11,191,85,106,135,66,69,119,50
06-11-2020 17:00:00,11,4,7,265,152,113,101,43,58,161,55
06-11-2020 18:00:00,8,4,4,203,105,98,106,56,50,147,55
06-11-2020 19:00:00,5,2,3,153,76,77,79,41,38,89,33
06-11-2020 20:00:00,6,3,3,122,63,59,60,40,20,66,39
06-11-2020 21:00:00,8,4,4,89,60,29,46,21,25,48,28
06-11-2020 22:00:00,4,1,3,54,33,21,25,8,17,30,12
06-11-2020 23:00:00,0,0,0,41,30,11,22,8,14,17,10
07-11-2020 00:00:00,1,1,0,18,14,4,6,3,3,8,2
07-11-2020 01:00:00,1,0,1,8,4,4,1,1,0,0,1
07-11-2020 02:00:00,0,0,0,11,6,5,1,0,1,0,4
07-11-2020 03:00:00,0,0,0,5,3,2,1,1,0,0,0
07-11-2020 04:00:00,0,0,0,9,3,6,2,1,1,0,5
07-11-2020 05:00:00,1,1,0,13,4,9,1,1,0,3,3
07-11-2020 06:00:00,0,0,0,27,6,21,22,21,1,13,16
07-11-2020 07:00:00,4,2,2,43,12,31,45,37,8,15,36
07-11-2020 08:00:00,5,5,0,57,18,39,31,29,2,15,28
07-11-2020 09:00:00,5,4,1,89,30,59,59,41,18,41,23
07-11-2020 10:00:00,14,7,7,134,52,82,69,49,20,34,29
07-11-2020 11:00:00,10,5,5,153,53,100,79,34,45,76,56
07-11-2020 12:00:00,20,11,9,158,63,95,114,83,31,85,68
07-11-2020 13:00:00,23,7,16,187,69,118,131,67,64,103,80
07-11-2020 14:00:00,31,18,13,160,75,85,130,70,60,80,62
07-11-2020 15:00:00,20,10,10,177,100,77,114,73,41,63,72
07-11-2020 16:00:00,15,5,10,158,79,79,80,38,42,78,71
07-11-2020 17:00:00,13,7,6,139,73,66,86,53,33,97,52
07-11-2020 18:00:00,5,2,3,135,65,70,74,43,31,71,75
07-11-2020 19:00:00,6,3,3,115,58,57,47,32,15,57,42
07-11-2020 20:00:00,3,2,1,92,45,47,53,31,22,59,34
07-11-2020 21:00:00,17,3,14,48,28,20,44,22,22,59,23
07-11-2020 22:00:00,6,5,1,58,36,22,33,16,17,17,8
07-11-2020 23:00:00,3,3,0,17,13,4,16,6,10,24,10
08-11-2020 00:00:00,0,0,0,16,5,11,8,4,4,12,12
08-11-2020 01:00:00,0,0,0,11,5,6,2,0,2,7,3
08-11-2020 02:00:00,1,0,1,4,2,2,3,1,2,4,0
08-11-2020 03:00:00,0,0,0,4,3,1,0,0,0,2,1
08-11-2020 04:00:00,0,0,0,3,2,1,2,2,0,6,3
08-11-2020 05:00:00,0,0,0,4,2,2,1,1,0,2,2
08-11-2020 06:00:00,1,1,0,19,6,13,7,7,0,6,6
08-11-2020 07:00:00,0,0,0,23,6,17,18,16,2,8,12
08-11-2020 08:00:00,7,6,1,40,9,31,25,22,3,13,13
08-11-2020 09:00:00,5,4,1,74,34,40,39,26,13,31,33
08-11-2020 10:00:00,12,9,3,87,26,61,71,40,31,37,31
08-11-2020 11:00:00,24,16,8,165,53,112,105,66,39,72,47
08-11-2020 12:00:00,20,10,10,151,63,88,96,63,33,56,47
08-11-2020 13:00:00,14,7,7,195,70,125,142,81,61,77,73
08-11-2020 14:00:00,14,10,4,150,55,95,112,64,48,67,40
08-11-2020 15:00:00,27,17,10,153,63,90,96,57,39,84,60
08-11-2020 16:00:00,18,11,7,175,92,83,124,71,53,74,61
08-11-2020 17:00:00,14,7,7,122,65,57,73,39,34,61,34
08-11-2020 18:00:00,13,4,9,94,46,48,59,28,31,63,27
08-11-2020 19:00:00,4,4,0,85,42,43,55,38,17,33,16
08-11-2020 20:00:00,4,1,3,71,36,35,39,17,22,37,10
08-11-2020 21:00:00,3,3,0,40,26,14,26,11,15,22,9
08-11-2020 22:00:00,3,3,0,43,34,9,19,10,9,24,4
08-11-2020 23:00:00,0,0,0,8,6,2,9,3,6,5,3
09-11-2020 00:00:00,0,0,0,6,3,3,7,1,6,7,2
09-11-2020 01:00:00,0,0,0,1,0,1,0,0,0,0,1
09-11-2020 02:00:00,0,0,0,0,0,0,0,0,0,0,0
09-11-2020 03:00:00,0,0,0,1,0,1,0,0,0,1,1
09-11-2020 04:00:00,0,0,0,8,2,6,0,0,0,1,2
09-11-2020 05:00:00,1,1,0,17,2,15,8,7,1,4,13
09-11-2020 06:00:00,6,6,0,78,8,70,91,86,5,11,55
09-11-2020 07:00:00,10,9,1,191,55,136,92,78,14,20,102
09-11-2020 08:00:00,22,18,4,243,72,171,117,109,8,43,147
09-11-2020 09:00:00,17,15,2,120,29,91,51,44,7,16,39
09-11-2020 10:00:00,5,0,5,61,18,43,34,27,7,13,35
09-11-2020 11:00:00,7,4,3,80,24,56,37,28,9,20,30
09-11-2020 12:00:00,6,6,0,100,42,58,45,30,15,36,34
09-11-2020 13:00:00,9,4,5,94,37,57,42,28,14,50,36
09-11-2020 14:00:00,6,1,5,86,53,33,40,15,25,45,28
09-11-2020 15:00:00,14,10,4,138,73,65,67,33,34,67,39
09-11-2020 16:00:00,9,5,4,159,85,74,69,30,39,130,37
09-11-2020 17:00:00,12,8,4,253,144,109,119,39,80,156,29
09-11-2020 18:00:00,17,6,11,187,108,79,88,34,54,121,35
09-11-2020 19:00:00,5,3,2,115,63,52,43,27,16,63,12
09-11-2020 20:00:00,7,6,1,68,40,28,23,9,14,37,15
09-11-2020 21:00:00,10,8,2,49,29,20,39,14,25,25,18
09-11-2020 22:00:00,3,2,1,29,17,12,25,11,14,21,2
09-11-2020 23:00:00,1,1,0,21,17,4,5,5,0,11,2
10-11-2020 00:00:00,0,0,0,4,0,4,4,2,2,2,4
10-11-2020 01:00:00,0,0,0,3,3,0,2,1,1,2,0
10-11-2020 02:00:00,0,0,0,2,0,2,0,0,0,0,3
10-11-2020 03:00:00,0,0,0,3,1,2,0,0,0,2,0
10-11-2020 04:00:00,0,0,0,5,1,4,1,1,0,2,2
10-11-2020 05:00:00,1,1,0,25,4,21,8,6,2,1,11
10-11-2020 06:00:00,3,2,1,91,18,73,91,81,10,16,59
10-11-2020 07:00:00,18,16,2,219,73,146,110,93,17,30,120
10-11-2020 08:00:00,24,19,5,277,88,189,141,125,16,42,184
10-11-2020 09:00:00,11,4,7,121,26,95,85,67,18,26,53
10-11-2020 10:00:00,4,4,0,86,36,50,35,29,6,21,20
10-11-2020 11:00:00,16,9,7,102,38,64,48,27,21,33,40
10-11-2020 12:00:00,10,5,5,116,45,71,65,36,29,48,41
10-11-2020 13:00:00,13,10,3,148,70,78,62,38,24,56,33
10-11-2020 14:00:00,11,6,5,105,50,55,58,31,27,74,36
10-11-2020 15:00:00,24,13,11,138,72,66,77,31,46,88,53
10-11-2020 16:00:00,17,8,9,197,98,99,91,35,56,125,40
10-11-2020 17:00:00,24,11,13,287,167,120,124,51,73,165,57
10-11-2020 18:00:00,12,7,5,196,110,86,120,56,64,130,37
10-11-2020 19:00:00,7,0,7,126,70,56,65,33,32,81,18
10-11-2020 20:00:00,5,5,0,82,41,41,36,22,14,46,16
10-11-2020 21:00:00,4,2,2,43,24,19,25,8,17,32,19
10-11-2020 22:00:00,3,1,2,23,18,5,27,9,18,29,12
10-11-2020 23:00:00,1,1,0,22,15,7,15,13,2,7,9
11-11-2020 00:00:00,2,2,0,7,3,4,10,4,6,7,3
11-11-2020 01:00:00,0,0,0,5,3,2,2,2,0,4,3
11-11-2020 02:00:00,0,0,0,1,0,1,2,0,2,1,4
11-11-2020 03:00:00,0,0,0,3,3,0,0,0,0,0,0
11-11-2020 04:00:00,0,0,0,10,3,7,0,0,0,1,3
11-11-2020 05:00:00,1,1,0,21,2,19,12,9,3,2,18
11-11-2020 06:00:00,7,6,1,74,13,61,81,74,7,17,65
11-11-2020 07:00:00,18,17,1,177,49,128,111,93,18,24,111
11-11-2020 08:00:00,19,17,2,251,68,183,112,103,9,37,135
11-11-2020 09:00:00,8,5,3,108,23,85,51,40,11,15,42
11-11-2020 10:00:00,6,2,4,46,18,28,23,14,9,19,32
11-11-2020 11:00:00,5,4,1,59,25,34,34,26,8,20,21
11-11-2020 12:00:00,3,2,1,88,35,53,41,31,10,45,28
11-11-2020 13:00:00,7,4,3,114,50,64,34,17,17,47,19
11-11-2020 14:00:00,5,2,3,90,32,58,31,14,17,40,13
11-11-2020 15:00:00,13,8,5,96,52,44,39,19,20,59,30
11-11-2020 16:00:00,12,5,7,147,66,81,75,33,42,90,30
11-11-2020 17:00:00,13,9,4,198,125,73,101,42,59,135,35
11-11-2020 18:00:00,10,3,7,150,74,76,77,21,56,103,25
11-11-2020 19:00:00,5,1,4,90,34,56,34,15,19,66,13
11-11-2020 20:00:00,3,3,0,56,35,21,43,19,24,37,15
11-11-2020 21:00:00,4,2,2,34,24,10,30,15,15,30,6
11-11-2020 22:00:00,2,2,0,26,18,8,13,6,7,21,8
11-11-2020 23:00:00,0,0,0,21,17,4,10,5,5,7,5
12-11-2020 00:00:00,2,2,0,5,2,3,4,1,3,8,2
12-11-2020 01:00:00,0,0,0,1,1,0,2,2,0,1,2
12-11-2020 02:00:00,0,0,0,2,2,0,0,0,0,0,2
12-11-2020 03:00:00,1,1,0,6,4,2,0,0,0,1,0
12-11-2020 04:00:00,0,0,0,7,1,6,0,0,0,1,1
12-11-2020 05:00:00,0,0,0,21,3,18,9,7,2,1,12
12-11-2020 06:00:00,4,3,1,85,16,69,75,68,7,16,46
12-11-2020 07:00:00,19,14,5,170,53,117,105,89,16,36,112
12-11-2020 08:00:00,30,26,4,268,66,202,129,120,9,39,120
12-11-2020 09:00:00,8,5,3,136,41,95,59,52,7,26,62
12-11-2020 10:00:00,4,2,2,106,37,69,38,28,10,19,29
12-11-2020 11:00:00,9,3,6,116,36,80,51,35,16,37,33
12-11-2020 12:00:00,10,7,3,131,53,78,63,42,21,37,38
12-11-2020 13:00:00,8,4,4,134,69,65,69,49,20,55,62
12-11-2020 14:00:00,13,6,7,116,66,50,59,31,28,57,39
12-11-2020 15:00:00,12,7,5,154,83,71,66,29,37,73,41
12-11-2020 16:00:00,17,8,9,164,89,75,93,36,57,109,21
12-11-2020 17:00:00,17,6,11,241,151,90,120,47,73,168,42
12-11-2020 18:00:00,20,13,7,192,83,109,95,44,51,146,31
12-11-2020 19:00:00,9,2,7,135,81,54,60,33,27,57,31
12-11-2020 20:00:00,4,0,4,104,59,45,44,27,17,57,28
12-11-2020 21:00:00,2,1,1,68,42,26,31,13,18,44,12
12-11-2020 22:00:00,2,1,1,54,33,21,28,13,15,25,14
12-11-2020 23:00:00,3,1,2,23,14,9,6,2,4,7,2
13-11-2020 00:00:00,2,2,0,6,3,3,1,0,1,4,3
13-11-2020 01:00:00,0,0,0,3,2,1,3,2,1,2,2
13-11-2020 02:00:00,0,0,0,0,0,0,0,0,0,3,1
13-11-2020 03:00:00,0,0,0,4,3,1,0,0,0,1,1
13-11-2020 04:00:00,0,0,0,11,3,8,1,0,1,0,3
13-11-2020 05:00:00,0,0,0,24,2,22,8,7,1,3,12
13-11-2020 06:00:00,4,3,1,76,13,63,81,76,5,18,50
13-11-2020 07:00:00,13,11,2,172,47,125,104,87,17,27,95
13-11-2020 08:00:00,32,23,9,250,73,177,137,117,20,46,111
13-11-2020 09:00:00,10,5,5,125,36,89,78,63,15,17,60
13-11-2020 10:00:00,2,1,1,114,51,63,44,32,12,22,35
13-11-2020 11:00:00,12,9,3,106,28,78,64,46,18,44,27
13-11-2020 12:00:00,11,8,3,133,56,77,72,50,22,69,45
13-11-2020 13:00:00,20,11,9,160,77,83,97,43,54,76,53
13-11-2020 14:00:00,18,10,8,130,65,65,80,48,32,89,39
13-11-2020 15:00:00,20,14,6,162,81,81,94,49,45,98,60
13-11-2020 16:00:00,15,5,10,201,102,99,111,57,54,115,43
13-11-2020 17:00:00,9,4,5,274,143,131,119,48,71,159,44
13-11-2020 18:00:00,13,9,4,236,118,118,83,38,45,127,43
13-11-2020 19:00:00,6,3,3,147,75,72,63,38,25,77,26
13-11-2020 20:00:00,9,7,2,120,67,53,50,25,25,59,27
13-11-2020 21:00:00,5,4,1,73,36,37,42,19,23,55,23
13-11-2020 22:00:00,2,2,0,46,31,15,24,12,12,35,8
13-11-2020 23:00:00,3,1,2,30,23,7,20,15,5,19,10
14-11-2020 00:00:00,0,0,0,16,8,8,8,7,1,7,8
14-11-2020 01:00:00,0,0,0,14,8,6,2,0,2,9,3
14-11-2020 02:00:00,0,0,0,5,4,1,3,1,2,4,2
14-11-2020 03:00:00,0,0,0,6,5,1,1,1,0,3,2
14-11-2020 04:00:00,0,0,0,7,1,6,4,2,2,2,4
14-11-2020 05:00:00,2,2,0,15,5,10,4,3,1,2,3
14-11-2020 06:00:00,2,1,1,28,7,21,11,11,0,10,15
14-11-2020 07:00:00,3,1,2,50,9,41,32,29,3,13,24
14-11-2020 08:00:00,4,3,1,54,15,39,38,24,14,16,27
14-11-2020 09:00:00,6,4,2,97,39,58,31,27,4,29,24
14-11-2020 10:00:00,13,9,4,92,32,60,37,27,10,39,37
14-11-2020 11:00:00,14,6,8,122,44,78,72,32,40,62,43
14-11-2020 12:00:00,15,6,9,112,44,68,52,32,20,40,31
14-11-2020 13:00:00,10,8,2,93,43,50,53,31,22,57,26
14-11-2020 14:00:00,13,8,5,107,48,59,73,45,28,75,31
14-11-2020 15:00:00,12,6,6,149,68,81,78,48,30,74,40
14-11-2020 16:00:00,14,9,5,130,61,69,70,29,41,54,31
14-11-2020 17:00:00,5,3,2,112,49,63,68,33,35,53,40
14-11-2020 18:00:00,8,4,4,101,57,44,52,36,16,47,41
14-11-2020 19:00:00,4,4,0,94,50,44,65,45,20,63,31
14-11-2020 20:00:00,6,5,1,70,29,41,37,25,12,26,30
14-11-2020 21:00:00,5,5,0,68,37,31,34,17,17,38,17
14-11-2020 22:00:00,1,0,1,34,23,11,36,17,19,25,8
14-11-2020 23:00:00,2,1,1,23,19,4,16,5,11,14,11
15-11-2020 00:00:00,1,0,1,23,10,13,5,1,4,14,6
15-11-2020 01:00:00,1,1,0,5,2,3,4,2,2,13,3
15-11-2020 02:00:00,0,0,0,7,5,2,0,0,0,5,0
15-11-2020 03:00:00,0,0,0,4,3,1,1,0,1,0,2
15-11-2020 04:00:00,0,0,0,3,0,3,0,0,0,2,6
15-11-2020 05:00:00,0,0,0,4,1,3,3,2,1,3,5
15-11-2020 06:00:00,1,1,0,15,4,11,12,10,2,8,7
15-11-2020 07:00:00,1,0,1,23,5,18,14,11,3,8,11
15-11-2020 08:00:00,2,2,0,38,11,27,15,10,5,12,12
15-11-2020 09:00:00,5,3,2,40,21,19,23,16,7,9,15
15-11-2020 10:00:00,8,6,2,50,19,31,22,15,7,21,19
15-11-2020 11:00:00,3,3,0,69,18,51,49,30,19,33,17
15-11-2020 12:00:00,13,7,6,91,39,52,61,38,23,33,24
15-11-2020 13:00:00,10,7,3,94,37,57,71,38,33,48,42
15-11-2020 14:00:00,11,2,9,91,44,47,62,31,31,40,57
15-11-2020 15:00:00,4,2,2,81,41,40,39,17,22,51,28
15-11-2020 16:00:00,9,8,1,91,47,44,71,45,26,52,34
15-11-2020 17:00:00,6,5,1,75,31,44,43,24,19,46,20
15-11-2020 18:00:00,8,4,4,76,36,40,43,22,21,38,8
15-11-2020 19:00:00,8,4,4,89,49,40,42,26,16,43,6
15-11-2020 20:00:00,6,4,2,72,44,28,28,17,11,33,11
15-11-2020 21:00:00,2,0,2,46,24,22,23,10,13,18,3
15-11-2020 22:00:00,3,2,1,38,23,15,19,9,10,19,5
15-11-2020 23:00:00,2,1,1,14,11,3,6,5,1,3,2
16-11-2020 00:00:00,0,0,0,5,1,4,1,1,0,5,2
16-11-2020 01:00:00,0,0,0,1,1,0,0,0,0,1,0
16-11-2020 02:00:00,0,0,0,0,0,0,1,1,0,1,0
16-11-2020 03:00:00,0,0,0,3,1,2,0,0,0,1,2
16-11-2020 04:00:00,0,0,0,7,1,6,0,0,0,1,4
16-11-2020 05:00:00,1,1,0,22,2,20,8,7,1,2,10
16-11-2020 06:00:00,5,4,1,73,13,60,80,72,8,13,56
16-11-2020 07:00:00,12,9,3,173,54,119,112,93,19,27,94
16-11-2020 08:00:00,25,20,5,275,85,190,123,109,14,46,148
16-11-2020 09:00:00,8,5,3,124,37,87,68,57,11,18,55
16-11-2020 10:00:00,3,2,1,73,26,47,37,29,8,15,34
16-11-2020 11:00:00,10,7,3,75,30,45,34,23,11,26,25
16-11-2020 12:00:00,7,3,4,98,40,58,54,34,20,33,33
16-11-2020 13:00:00,2,1,1,84,38,46,40,24,16,47,26
16-11-2020 14:00:00,11,8,3,93,40,53,37,21,16,34,21
16-11-2020 15:00:00,9,7,2,97,41,56,58,27,31,70,34
16-11-2020 16:00:00,12,8,4,157,88,69,80,32,48,118,28
16-11-2020 17:00:00,13,6,7,237,141,96,103,32,71,160,22
16-11-2020 18:00:00,8,7,1,172,84,88,83,31,52,114,23
16-11-2020 19:00:00,2,1,1,99,65,34,49,27,22,37,15
16-11-2020 20:00:00,0,0,0,61,38,23,28,15,13,37,9
16-11-2020 21:00:00,3,2,1,37,26,11,31,10,21,29,13
16-11-2020 22:00:00,3,3,0,31,24,7,19,7,12,25,15
16-11-2020 23:00:00,2,2,0,13,8,5,11,4,7,11,5
17-11-2020 00:00:00,0,0,0,4,2,2,4,2,2,7,2
17-11-2020 01:00:00,0,0,0,1,1,0,0,0,0,1,3
17-11-2020 02:00:00,0,0,0,0,0,0,0,0,0,2,2
17-11-2020 03:00:00,0,0,0,4,2,2,1,1,0,0,0
17-11-2020 04:00:00,0,0,0,6,0,6,1,1,0,0,0
17-11-2020 05:00:00,1,1,0,19,1,18,9,8,1,2,12
17-11-2020 06:00:00,5,5,0,86,15,71,81,73,8,16,67
17-11-2020 07:00:00,19,12,7,195,63,132,93,79,14,19,100
17-11-2020 08:00:00,26,22,4,280,69,211,133,121,12,47,162
17-11-2020 09:00:00,8,5,3,135,35,100,68,55,13,31,65
17-11-2020 10:00:00,10,7,3,74,33,41,35,26,9,31,44
17-11-2020 11:00:00,8,4,4,99,31,68,53,33,20,23,37
17-11-2020 12:00:00,10,7,3,127,47,80,61,45,16,46,43
17-11-2020 13:00:00,14,7,7,128,61,67,79,55,24,68,52
17-11-2020 14:00:00,12,3,9,126,60,66,68,43,25,66,38
17-11-2020 15:00:00,13,8,5,149,73,76,68,37,31,71,45
17-11-2020 16:00:00,14,10,4,190,101,89,93,35,58,133,36
17-11-2020 17:00:00,17,8,9,263,145,118,136,49,87,169,36
17-11-2020 18:00:00,18,10,8,199,117,82,110,41,69,144,35
17-11-2020 19:00:00,9,4,5,137,80,57,60,36,24,80,19
17-11-2020 20:00:00,4,1,3,85,42,43,44,16,28,57,15
17-11-2020 21:00:00,4,2,2,47,30,17,33,11,22,32,12
17-11-2020 22:00:00,2,2,0,33,21,12,14,8,6,18,3
17-11-2020 23:00:00,3,1,2,20,9,11,8,6,2,12,3
18-11-2020 00:00:00,3,2,1,10,6,4,0,0,0,5,4
18-11-2020 01:00:00,0,0,0,3,2,1,2,2,0,2,2
18-11-2020 02:00:00,0,0,0,0,0,0,0,0,0,0,2
18-11-2020 03:00:00,1,0,1,3,1,2,1,1,0,0,0
18-11-2020 04:00:00,0,0,0,11,3,8,2,0,2,2,2
18-11-2020 05:00:00,1,1,0,17,2,15,12,9,3,4,17
18-11-2020 06:00:00,9,8,1,73,14,59,89,79,10,14,63
18-11-2020 07:00:00,11,8,3,205,64,141,104,92,12,18,107
18-11-2020 08:00:00,20,14,6,204,53,151,109,102,7,37,135
18-11-2020 09:00:00,8,6,2,100,23,77,51,43,8,15,49
18-11-2020 10:00:00,6,2,4,63,20,43,20,13,7,12,24
18-11-2020 11:00:00,8,7,1,67,21,46,53,40,13,14,28
18-11-2020 12:00:00,7,5,2,106,39,67,50,37,13,41,35
18-11-2020 13:00:00,10,6,4,128,60,68,57,38,19,62,41
18-11-2020 14:00:00,19,11,8,121,58,63,57,35,22,50,29
18-11-2020 15:00:00,22,14,8,134,68,66,65,33,32,60,29
18-11-2020 16:00:00,18,11,7,179,89,90,74,32,42,103,43
18-11-2020 17:00:00,16,7,9,238,133,105,106,41,65,131,21
18-11-2020 18:00:00,6,2,4,162,89,73,79,30,49,103,22
18-11-2020 19:00:00,8,4,4,100,53,47,54,16,38,66,12
18-11-2020 20:00:00,2,2,0,73,34,39,32,16,16,47,11
18-11-2020 21:00:00,4,1,3,24,15,9,36,12,24,18,10
18-11-2020 22:00:00,0,0,0,29,19,10,19,7,12,29,8
18-11-2020 23:00:00,0,0,0,13,10,3,12,8,4,7,1
19-11-2020 00:00:00,0,0,0,11,3,8,2,2,0,7,2
19-11-2020 01:00:00,0,0,0,6,2,4,0,0,0,2,2
19-11-2020 02:00:00,0,0,0,0,0,0,0,0,0,3,3
19-11-2020 03:00:00,0,0,0,6,4,2,1,1,0,0,0
19-11-2020 04:00:00,0,0,0,11,3,8,1,1,0,0,1
19-11-2020 05:00:00,1,1,0,22,1,21,8,5,3,2,8
19-11-2020 06:00:00,7,5,2,74,12,62,81,78,3,14,57
19-11-2020 07:00:00,11,7,4,178,53,125,91,78,13,26,100
19-11-2020 08:00:00,25,22,3,254,64,190,131,119,12,40,127
19-11-2020 09:00:00,7,4,3,130,41,89,64,53,11,28,61
19-11-2020 10:00:00,14,8,6,95,25,70,42,31,11,34,33
19-11-2020 11:00:00,10,6,4,104,31,73,69,49,20,43,41
19-11-2020 12:00:00,10,6,4,119,42,77,58,33,25,60,38
19-11-2020 13:00:00,21,11,10,133,52,81,67,42,25,75,57
19-11-2020 14:00:00,18,9,9,155,62,93,69,34,35,51,49
19-11-2020 15:00:00,15,10,5,137,73,64,82,41,41,90,33
19-11-2020 16:00:00,15,7,8,185,81,104,74,28,46,126,41
19-11-2020 17:00:00,18,5,13,238,137,101,128,64,64,124,45
19-11-2020 18:00:00,11,6,5,227,109,118,88,33,55,136,31
19-11-2020 19:00:00,7,2,5,138,67,71,70,33,37,72,31
19-11-2020 20:00:00,9,6,3,94,53,41,46,19,27,63,20
19-11-2020 21:00:00,3,1,2,59,36,23,27,11,16,39,16
19-11-2020 22:00:00,1,0,1,35,24,11,17,5,12,29,8
19-11-2020 23:00:00,1,1,0,29,13,16,6,5,1,11,8
20-11-2020 00:00:00,4,2,2,13,6,7,2,1,1,10,1
20-11-2020 01:00:00,2,2,0,10,6,4,1,1,0,3,6
20-11-2020 02:00:00,0,0,0,5,1,4,0,0,0,0,0
20-11-2020 03:00:00,0,0,0,3,3,0,2,1,1,2,0
20-11-2020 04:00:00,0,0,0,12,4,8,2,1,1,1,4
20-11-2020 05:00:00,0,0,0,20,0,20,6,5,1,4,10
20-11-2020 06:00:00,6,6,0,65,13,52,78,71,7,11,48
20-11-2020 07:00:00,9,6,3,133,40,93,81,66,15,21,55
20-11-2020 08:00:00,24,20,4,257,67,190,108,99,9,41,127
20-11-2020 09:00:00,7,5,2,98,24,74,61,49,12,19,47
20-11-2020 10:00:00,2,1,1,86,26,60,26,19,7,22,25
20-11-2020 11:00:00,7,3,4,86,25,61,42,31,11,25,17
20-11-2020 12:00:00,11,6,5,112,52,60,65,45,20,49,40
20-11-2020 13:00:00,8,5,3,134,72,62,69,46,23,55,42
20-11-2020 14:00:00,9,4,5,112,45,67,58,31,27,59,31
20-11-2020 15:00:00,10,6,4,154,80,74,80,46,34,97,54
20-11-2020 16:00:00,21,11,10,188,80,108,90,42,48,90,35
20-11-2020 17:00:00,12,5,7,224,134,90,97,44,53,122,32
20-11-2020 18:00:00,10,5,5,195,108,87,84,50,34,103,33
20-11-2020 19:00:00,8,5,3,142,80,62,66,34,32,80,33
20-11-2020 20:00:00,6,3,3,118,67,51,47,30,17,45,30
20-11-2020 21:00:00,7,2,5,74,40,34,44,21,23,33,19
20-11-2020 22:00:00,1,1,0,70,43,27,28,13,15,21,12
20-11-2020 23:00:00,0,0,0,33,20,13,20,11,9,20,10
21-11-2020 00:00:00,2,0,2,17,11,6,7,2,5,16,0
21-11-2020 01:00:00,0,0,0,13,8,5,5,2,3,6,3
21-11-2020 02:00:00,3,0,3,3,2,1,5,0,5,4,3
21-11-2020 03:00:00,0,0,0,8,5,3,0,0,0,6,0
21-11-2020 04:00:00,0,0,0,5,1,4,2,2,0,1,4
21-11-2020 05:00:00,1,1,0,11,3,8,2,2,0,1,6
21-11-2020 06:00:00,0,0,0,35,7,28,11,10,1,6,16
21-11-2020 07:00:00,4,1,3,45,12,33,45,38,7,17,27
21-11-2020 08:00:00,6,5,1,56,16,40,27,20,7,17,26
21-11-2020 09:00:00,3,1,2,66,23,43,25,16,9,27,11
21-11-2020 10:00:00,12,8,4,83,36,47,43,31,12,27,32
21-11-2020 11:00:00,15,10,5,120,41,79,73,46,27,40,43
21-11-2020 12:00:00,14,7,7,152,66,86,102,59,43,83,60
21-11-2020 13:00:00,21,10,11,175,74,101,109,63,46,93,63
21-11-2020 14:00:00,26,9,17,182,73,109,103,56,47,89,92
21-11-2020 15:00:00,17,9,8,148,55,93,101,47,54,87,68
21-11-2020 16:00:00,11,4,7,143,72,71,83,47,36,80,77
21-11-2020 17:00:00,10,8,2,141,71,70,65,41,24,69,58
21-11-2020 18:00:00,8,4,4,121,56,65,64,43,21,76,28
21-11-2020 19:00:00,12,7,5,101,52,49,60,34,26,54,20
21-11-2020 20:00:00,6,3,3,100,46,54,45,21,24,55,33
21-11-2020 21:00:00,14,8,6,65,36,29,48,32,16,49,10
21-11-2020 22:00:00,7,4,3,49,31,18,33,12,21,31,16
21-11-2020 23:00:00,1,1,0,25,15,10,17,7,10,22,6
22-11-2020 00:00:00,3,1,2,27,17,10,10,6,4,14,5
22-11-2020 01:00:00,2,1,1,10,6,4,11,4,7,2,4
22-11-2020 02:00:00,1,1,0,8,4,4,8,0,8,7,1
22-11-2020 03:00:00,0,0,0,3,2,1,4,1,3,7,1
22-11-2020 04:00:00,0,0,0,6,3,3,1,0,1,5,1
22-11-2020 05:00:00,0,0,0,7,1,6,4,2,2,2,2
22-11-2020 06:00:00,1,1,0,16,4,12,7,6,1,7,7
22-11-2020 07:00:00,1,1,0,26,4,22,14,12,2,18,12
22-11-2020 08:00:00,4,4,0,45,22,23,24,19,5,17,16
22-11-2020 09:00:00,8,4,4,78,39,39,53,29,24,39,17
22-11-2020 10:00:00,11,7,4,116,37,79,73,55,18,65,39
22-11-2020 11:00:00,14,7,7,159,63,96,93,54,39,74,36
22-11-2020 12:00:00,18,13,5,213,77,136,134,86,48,87,47
22-11-2020 13:00:00,29,20,9,178,80,98,137,87,50,96,82
22-11-2020 14:00:00,30,16,14,157,63,94,128,78,50,100,70
22-11-2020 15:00:00,28,12,16,176,82,94,106,60,46,72,65
22-11-2020 16:00:00,23,8,15,132,70,62,85,41,44,61,64
22-11-2020 17:00:00,8,5,3,105,56,49,51,27,24,55,44
22-11-2020 18:00:00,9,5,4,93,44,49,54,33,21,56,28
22-11-2020 19:00:00,7,5,2,93,53,40,45,23,22,45,11
22-11-2020 20:00:00,4,2,2,67,37,30,42,26,16,38,10
22-11-2020 21:00:00,3,3,0,51,31,20,22,13,9,27,5
22-11-2020 22:00:00,4,2,2,34,20,14,14,4,10,17,4
22-11-2020 23:00:00,1,0,1,19,13,6,4,2,2,3,1
23-11-2020 00:00:00,0,0,0,5,1,4,1,1,0,4,1
23-11-2020 01:00:00,0,0,0,3,0,3,0,0,0,1,1
23-11-2020 02:00:00,0,0,0,0,0,0,0,0,0,1,1
23-11-2020 03:00:00,0,0,0,4,3,1,0,0,0,1,1
23-11-2020 04:00:00,0,0,0,7,2,5,0,0,0,0,2
23-11-2020 05:00:00,1,1,0,15,1,14,9,9,0,2,10
23-11-2020 06:00:00,6,5,1,78,15,63,84,75,9,13,64
23-11-2020 07:00:00,12,9,3,199,60,139,116,94,22,28,100
23-11-2020 08:00:00,31,27,4,258,79,179,136,127,9,47,140
23-11-2020 09:00:00,8,6,2,121,24,97,66,54,12,25,37
23-11-2020 10:00:00,4,2,2,66,26,40,28,22,6,10,32
23-11-2020 11:00:00,3,1,2,79,31,48,44,34,10,27,32
23-11-2020 12:00:00,3,1,2,96,36,60,44,31,13,44,29
23-11-2020 13:00:00,8,2,6,100,47,53,57,32,25,42,44
23-11-2020 14:00:00,15,7,8,82,45,37,52,25,27,40,28
23-11-2020 15:00:00,14,10,4,123,59,64,71,34,37,70,44
23-11-2020 16:00:00,15,8,7,175,105,70,76,33,43,109,38
23-11-2020 17:00:00,11,7,4,269,161,108,108,45,63,155,39
23-11-2020 18:00:00,9,4,5,180,94,86,82,36,46,135,22
23-11-2020 19:00:00,3,1,2,105,61,44,54,26,28,40,3
23-11-2020 20:00:00,5,4,1,74,49,25,37,25,12,50,25
23-11-2020 21:00:00,9,6,3,39,23,16,29,8,21,41,11
23-11-2020 22:00:00,1,0,1,26,15,11,14,6,8,21,6
23-11-2020 23:00:00,1,1,0,13,11,2,5,4,1,3,3
24-11-2020 00:00:00,1,1,0,9,4,5,6,1,5,7,2
24-11-2020 01:00:00,0,0,0,1,0,1,1,1,0,2,2
24-11-2020 02:00:00,0,0,0,3,2,1,3,1,2,4,1
24-11-2020 03:00:00,0,0,0,5,2,3,1,1,0,0,0
24-11-2020 04:00:00,0,0,0,8,3,5,1,1,0,1,3
24-11-2020 05:00:00,1,1,0,17,1,16,10,9,1,3,11
24-11-2020 06:00:00,8,8,0,91,21,70,99,91,8,17,67
24-11-2020 07:00:00,20,17,3,188,53,135,98,84,14,21,112
24-11-2020 08:00:00,32,22,10,279,74,205,140,128,12,47,134
24-11-2020 09:00:00,7,5,2,121,23,98,61,51,10,21,55
24-11-2020 10:00:00,4,4,0,69,28,41,33,25,8,19,26
24-11-2020 11:00:00,6,3,3,95,31,64,52,39,13,29,36
24-11-2020 12:00:00,8,5,3,110,38,72,48,31,17,60,36
24-11-2020 13:00:00,5,3,2,113,49,64,62,41,21,44,45
24-11-2020 14:00:00,14,5,9,94,51,43,50,22,28,59,33
24-11-2020 15:00:00,12,8,4,129,64,65,61,26,35,74,44
24-11-2020 16:00:00,19,11,8,179,90,89,80,33,47,96,39
24-11-2020 17:00:00,18,5,13,245,154,91,116,46,70,149,38
24-11-2020 18:00:00,11,5,6,187,105,82,66,22,44,140,25
24-11-2020 19:00:00,4,2,2,101,59,42,46,22,24,43,12
24-11-2020 20:00:00,4,2,2,65,35,30,28,12,16,37,14
24-11-2020 21:00:00,5,4,1,30,17,13,24,6,18,25,6
24-11-2020 22:00:00,0,0,0,35,24,11,13,2,11,16,2
24-11-2020 23:00:00,0,0,0,19,12,7,4,1,3,2,4
25-11-2020 00:00:00,0,0,0,9,5,4,2,0,2,1,3
25-11-2020 01:00:00,1,0,1,1,1,0,1,1,0,0,0
25-11-2020 02:00:00,1,1,0,0,0,0,0,0,0,0,1
25-11-2020 03:00:00,1,0,1,3,1,2,1,1,0,0,0
25-11-2020 04:00:00,0,0,0,8,3,5,0,0,0,1,3
25-11-2020 05:00:00,2,2,0,18,1,17,13,10,3,6,12
25-11-2020 06:00:00,2,2,0,78,17,61,84,81,3,15,70
25-11-2020 07:00:00,15,13,2,222,75,147,119,100,19,27,100
25-11-2020 08:00:00,29,21,8,265,63,202,132,125,7,35,141
25-11-2020 09:00:00,7,7,0,116,27,89,69,56,13,22,55
25-11-2020 10:00:00,11,7,4,80,26,54,36,30,6,27,37
25-11-2020 11:00:00,3,2,1,98,35,63,60,38,22,31,25
25-11-2020 12:00:00,6,5,1,145,51,94,71,44,27,53,60
25-11-2020 13:00:00,18,9,9,155,51,104,79,43,36,66,33
25-11-2020 14:00:00,17,10,7,151,77,74,100,57,43,55,37
25-11-2020 15:00:00,14,7,7,138,58,80,79,35,44,79,51
25-11-2020 16:00:00,18,8,10,201,107,94,100,37,63,113,33
25-11-2020 17:00:00,17,7,10,272,142,130,120,51,69,166,24
25-11-2020 18:00:00,7,3,4,207,122,85,85,37,48,114,26
25-11-2020 19:00:00,5,3,2,128,58,70,84,58,26,93,21
25-11-2020 20:00:00,4,4,0,78,42,36,39,27,12,52,34
25-11-2020 21:00:00,5,3,2,67,38,29,34,10,24,44,14
25-11-2020 22:00:00,0,0,0,54,36,18,17,5,12,23,6
25-11-2020 23:00:00,2,0,2,29,21,8,11,4,7,4,7
26-11-2020 00:00:00,1,1,0,5,1,4,1,0,1,0,2
26-11-2020 01:00:00,0,0,0,3,2,1,3,2,1,0,0
26-11-2020 02:00:00,0,0,0,2,0,2,0,0,0,0,1
26-11-2020 03:00:00,0,0,0,4,3,1,1,1,0,1,0
26-11-2020 04:00:00,0,0,0,8,1,7,1,0,1,1,3
26-11-2020 05:00:00,0,0,0,20,2,18,11,9,2,3,9
26-11-2020 06:00:00,5,3,2,78,14,64,82,76,6,15,65
26-11-2020 07:00:00,14,11,3,200,58,142,113,98,15,35,104
26-11-2020 08:00:00,28,24,4,259,66,193,123,114,9,34,142
26-11-2020 09:00:00,10,7,3,133,40,93,60,50,10,14,50
26-11-2020 10:00:00,5,5,0,86,35,51,32,23,9,16,41
26-11-2020 11:00:00,9,6,3,81,27,54,47,31,16,22,38
26-11-2020 12:00:00,5,3,2,122,43,79,70,37,33,58,51
26-11-2020 13:00:00,14,9,5,140,65,75,62,40,22,64,45
26-11-2020 14:00:00,16,6,10,112,51,61,73,41,32,67,41
26-11-2020 15:00:00,10,7,3,146,61,85,72,28,44,66,35
26-11-2020 16:00:00,23,13,10,177,94,83,95,36,59,109,41
26-11-2020 17:00:00,10,7,3,248,138,110,131,53,78,158,56
26-11-2020 18:00:00,15,10,5,209,113,96,87,37,50,116,24
26-11-2020 19:00:00,9,2,7,141,78,63,69,33,36,50,16
26-11-2020 20:00:00,2,0,2,107,53,54,45,23,22,59,16
26-11-2020 21:00:00,3,1,2,70,44,26,37,23,14,42,15
26-11-2020 22:00:00,3,1,2,30,20,10,30,10,20,24,9
26-11-2020 23:00:00,3,1,2,30,18,12,15,8,7,16,10
27-11-2020 00:00:00,1,0,1,21,10,11,9,5,4,10,5
27-11-2020 01:00:00,0,0,0,2,1,1,1,1,0,5,3
27-11-2020 02:00:00,0,0,0,5,4,1,1,1,0,3,0
27-11-2020 03:00:00,0,0,0,4,3,1,1,1,0,0,0
27-11-2020 04:00:00,0,0,0,11,3,8,5,3,2,0,3
27-11-2020 05:00:00,0,0,0,24,2,22,11,10,1,2,14
27-11-2020 06:00:00,3,2,1,78,11,67,87,82,5,11,65
27-11-2020 07:00:00,12,9,3,166,50,116,99,90,9,27,86
27-11-2020 08:00:00,27,21,6,251,64,187,123,114,9,44,128
27-11-2020 09:00:00,10,8,2,121,23,98,74,55,19,27,59
27-11-2020 10:00:00,6,2,4,98,24,74,42,29,13,22,31
27-11-2020 11:00:00,20,15,5,100,32,68,64,44,20,37,30
27-11-2020 12:00:00,14,6,8,137,52,85,63,37,26,67,45
27-11-2020 13:00:00,16,8,8,140,67,73,99,49,50,89,41
27-11-2020 14:00:00,24,15,9,148,74,74,97,50,47,76,38
27-11-2020 15:00:00,19,8,11,151,71,80,97,47,50,104,54
27-11-2020 16:00:00,12,6,6,186,87,99,95,40,55,119,50
27-11-2020 17:00:00,12,5,7,229,130,99,100,40,60,134,29
27-11-2020 18:00:00,12,6,6,194,98,96,92,43,49,121,40
27-11-2020 19:00:00,9,2,7,159,75,84,73,46,27,82,50
27-11-2020 20:00:00,9,4,5,125,75,50,48,26,22,59,45
27-11-2020 21:00:00,3,2,1,75,48,27,39,16,23,43,24
27-11-2020 22:00:00,4,3,1,71,43,28,34,17,17,11,17
27-11-2020 23:00:00,0,0,0,32,17,15,17,11,6,2,9
28-11-2020 00:00:00,1,1,0,17,11,6,5,3,2,7,4
28-11-2020 01:00:00,2,1,1,17,11,6,2,1,1,9,2
28-11-2020 02:00:00,0,0,0,7,4,3,4,1,3,6,2
28-11-2020 03:00:00,0,0,0,6,5,1,2,0,2,3,1
28-11-2020 04:00:00,0,0,0,6,3,3,0,0,0,1,2
28-11-2020 05:00:00,1,1,0,10,2,8,8,6,2,3,7
28-11-2020 06:00:00,3,1,2,27,5,22,19,19,0,6,16
28-11-2020 07:00:00,2,1,1,43,12,31,40,30,10,14,32
28-11-2020 08:00:00,4,4,0,61,16,45,29,23,6,23,24
28-11-2020 09:00:00,6,4,2,73,28,45,44,34,10,23,36
28-11-2020 10:00:00,9,9,0,95,31,64,44,26,18,41,30
28-11-2020 11:00:00,11,5,6,124,53,71,91,55,36,45,60
28-11-2020 12:00:00,17,8,9,140,65,75,84,52,32,67,48
28-11-2020 13:00:00,12,9,3,141,65,76,87,54,33,71,58
28-11-2020 14:00:00,15,8,7,151,74,77,91,55,36,79,60
28-11-2020 15:00:00,18,13,5,171,64,107,81,34,47,75,73
28-11-2020 16:00:00,8,7,1,135,61,74,69,40,29,90,65
28-11-2020 17:00:00,10,6,4,107,58,49,76,34,42,71,45
28-11-2020 18:00:00,5,1,4,108,52,56,58,29,29,58,34
28-11-2020 19:00:00,7,5,2,120,63,57,64,29,35,70,35
28-11-2020 20:00:00,7,4,3,83,38,45,41,22,19,47,23
28-11-2020 21:00:00,7,4,3,68,37,31,34,22,12,34,22
28-11-2020 22:00:00,1,1,0,48,34,14,17,9,8,25,10
28-11-2020 23:00:00,2,2,0,30,21,9,17,12,5,16,7
29-11-2020 00:00:00,2,1,1,22,8,14,7,4,3,14,6
29-11-2020 01:00:00,3,1,2,16,11,5,7,5,2,4,4
29-11-2020 02:00:00,0,0,0,5,4,1,2,0,2,8,0
29-11-2020 03:00:00,1,0,1,3,1,2,0,0,0,1,2
29-11-2020 04:00:00,0,0,0,6,2,4,1,0,1,2,2
29-11-2020 05:00:00,0,0,0,5,0,5,3,3,0,0,5
29-11-2020 06:00:00,1,1,0,13,4,9,7,5,2,6,10
29-11-2020 07:00:00,2,1,1,27,7,20,10,9,1,14,14
29-11-2020 08:00:00,4,2,2,48,18,30,16,14,2,18,17
29-11-2020 09:00:00,4,2,2,84,32,52,36,17,19,33,39
29-11-2020 10:00:00,17,12,5,71,21,50,74,43,31,51,36
29-11-2020 11:00:00,12,7,5,143,61,82,70,38,32,67,40
29-11-2020 12:00:00,14,10,4,114,49,65,83,46,37,61,61
29-11-2020 13:00:00,11,7,4,174,65,109,114,68,46,92,71
29-11-2020 14:00:00,13,8,5,175,73,102,94,59,35,73,58
29-11-2020 15:00:00,18,6,12,148,77,71,103,44,59,68,59
29-11-2020 16:00:00,13,6,7,149,80,69,74,42,32,70,53
29-11-2020 17:00:00,9,2,7,105,52,53,42,26,16,55,20
29-11-2020 18:00:00,5,2,3,96,41,55,56,34,22,55,29
29-11-2020 19:00:00,2,1,1,78,42,36,47,22,25,56,29
29-11-2020 20:00:00,4,2,2,78,37,41,34,19,15,42,14
29-11-2020 21:00:00,1,1,0,58,35,23,28,13,15,25,16
29-11-2020 22:00:00,3,1,2,29,19,10,23,12,11,22,5
29-11-2020 23:00:00,0,0,0,24,18,6,9,3,6,13,4
30-11-2020 00:00:00,0,0,0,9,4,5,3,2,1,6,2
30-11-2020 01:00:00,0,0,0,2,1,1,0,0,0,3,1
30-11-2020 02:00:00,0,0,0,1,1,0,0,0,0,1,0
30-11-2020 03:00:00,0,0,0,5,1,4,0,0,0,0,1
30-11-2020 04:00:00,0,0,0,7,1,6,2,1,1,1,3
30-11-2020 05:00:00,1,1,0,21,2,19,11,11,0,3,12
30-11-2020 06:00:00,5,5,0,79,13,66,81,71,10,13,70
30-11-2020 07:00:00,12,9,3,198,59,139,111,96,15,27,93
30-11-2020 08:00:00,25,22,3,256,69,187,129,117,12,39,148
30-11-2020 09:00:00,12,8,4,129,33,96,60,49,11,18,69
30-11-2020 10:00:00,6,5,1,69,18,51,28,21,7,14,26
30-11-2020 11:00:00,3,3,0,64,22,42,42,32,10,17,31
30-11-2020 12:00:00,6,4,2,88,37,51,47,30,17,38,30
30-11-2020 13:00:00,11,6,5,114,54,60,41,31,10,46,30
30-11-2020 14:00:00,8,5,3,108,58,50,49,25,24,61,16
30-11-2020 15:00:00,15,4,11,115,59,56,57,21,36,50,18
30-11-2020 16:00:00,12,8,4,178,91,87,73,28,45,108,27
30-11-2020 17:00:00,11,5,6,250,136,114,98,40,58,145,45
30-11-2020 18:00:00,9,5,4,186,102,84,78,28,50,104,19
30-11-2020 19:00:00,6,2,4,104,53,51,57,29,28,64,9
30-11-2020 20:00:00,7,3,4,67,40,27,67,28,39,42,10
30-11-2020 21:00:00,5,2,3,55,28,27,36,12,24,27,12
30-11-2020 22:00:00,6,4,2,37,24,13,19,8,11,15,8
30-11-2020 23:00:00,4,2,2,14,8,6,4,1,3,6,4
01-12-2020 00:00:00,1,1,0,10,4,6,4,3,1,3,1
01-12-2020 01:00:00,1,1,0,2,2,0,1,1,0,3,2
01-12-2020 02:00:00,0,0,0,0,0,0,1,1,0,1,1
01-12-2020 03:00:00,0,0,0,3,2,1,1,0,1,0,0
01-12-2020 04:00:00,1,1,0,6,2,4,0,0,0,0,1
01-12-2020 05:00:00,3,3,0,27,7,20,17,15,2,2,17
01-12-2020 06:00:00,9,7,2,91,15,76,88,80,8,13,54
01-12-2020 07:00:00,20,15,5,225,64,161,126,103,23,27,91
01-12-2020 08:00:00,31,25,6,283,74,209,148,135,13,45,162
01-12-2020 09:00:00,14,12,2,146,31,115,79,58,21,18,65
01-12-2020 10:00:00,12,6,6,83,19,64,49,28,21,29,38
01-12-2020 11:00:00,9,7,2,78,26,52,46,35,11,26,44
01-12-2020 12:00:00,12,6,6,108,34,74,61,36,25,45,44
01-12-2020 13:00:00,12,2,10,124,51,73,69,45,24,59,41
01-12-2020 14:00:00,9,6,3,144,61,83,58,31,27,53,36
01-12-2020 15:00:00,16,8,8,141,68,73,83,38,45,76,35
01-12-2020 16:00:00,12,4,8,228,110,118,81,34,47,121,49
01-12-2020 17:00:00,13,4,9,273,143,130,120,55,65,161,61
01-12-2020 18:00:00,15,11,4,236,135,101,104,42,62,172,42
01-12-2020 19:00:00,7,4,3,157,87,70,64,27,37,84,33
01-12-2020 20:00:00,5,1,4,101,56,45,54,30,24,62,31
01-12-2020 21:00:00,3,2,1,59,37,22,40,17,23,38,19
01-12-2020 22:00:00,3,2,1,44,31,13,15,5,10,38,5
01-12-2020 23:00:00,6,3,3,28,20,8,6,3,3,14,3
02-12-2020 00:00:00,1,1,0,7,3,4,1,0,1,9,5
02-12-2020 01:00:00,0,0,0,2,2,0,1,1,0,6,1
02-12-2020 02:00:00,1,0,1,2,0,2,1,0,1,1,1
02-12-2020 03:00:00,0,0,0,7,3,4,1,1,0,1,1
02-12-2020 04:00:00,0,0,0,9,4,5,1,1,0,1,8
02-12-2020 05:00:00,2,2,0,32,6,26,14,11,3,2,14
02-12-2020 06:00:00,9,7,2,83,15,68,93,88,5,14,71
02-12-2020 07:00:00,10,6,4,216,65,151,128,110,18,30,93
02-12-2020 08:00:00,34,32,2,281,76,205,144,135,9,49,161
02-12-2020 09:00:00,9,7,2,163,49,114,86,71,15,22,69
02-12-2020 10:00:00,14,8,6,89,21,68,42,28,14,20,35
02-12-2020 11:00:00,17,10,7,119,43,76,58,37,21,33,34
02-12-2020 12:00:00,14,9,5,135,42,93,59,35,24,62,26
02-12-2020 13:00:00,12,7,5,179,69,110,75,41,34,71,44
02-12-2020 14:00:00,15,3,12,132,58,74,80,44,36,72,28
02-12-2020 15:00:00,16,10,6,143,78,65,66,26,40,78,58
02-12-2020 16:00:00,14,6,8,190,86,104,92,39,53,131,48
02-12-2020 17:00:00,13,7,6,271,151,120,124,47,77,175,43
02-12-2020 18:00:00,6,1,5,249,132,117,105,45,60,155,30
02-12-2020 19:00:00,8,5,3,155,78,77,79,36,43,105,18
02-12-2020 20:00:00,7,4,3,113,67,46,55,22,33,68,29
02-12-2020 21:00:00,9,5,4,65,41,24,29,13,16,37,7
02-12-2020 22:00:00,1,0,1,48,32,16,19,7,12,36,5
02-12-2020 23:00:00,2,1,1,36,25,11,7,1,6,14,8
03-12-2020 00:00:00,2,2,0,12,4,8,4,2,2,5,1
03-12-2020 01:00:00,0,0,0,4,2,2,2,2,0,4,2
03-12-2020 02:00:00,0,0,0,2,1,1,1,0,1,2,2
03-12-2020 03:00:00,0,0,0,3,2,1,0,0,0,4,0
03-12-2020 04:00:00,0,0,0,6,0,6,1,1,0,3,5
03-12-2020 05:00:00,2,2,0,22,6,16,14,11,3,4,12
03-12-2020 06:00:00,5,3,2,78,8,70,73,69,4,11,49
03-12-2020 07:00:00,11,9,2,193,54,139,112,92,20,26,109
03-12-2020 08:00:00,32,25,7,274,64,210,161,146,15,36,155
03-12-2020 09:00:00,11,6,5,141,30,111,102,84,18,18,95
03-12-2020 10:00:00,8,5,3,85,22,63,33,23,10,16,48
03-12-2020 11:00:00,10,7,3,109,22,87,45,37,8,30,42
03-12-2020 12:00:00,8,7,1,131,50,81,63,43,20,42,42
03-12-2020 13:00:00,4,2,2,143,55,88,59,34,25,56,52
03-12-2020 14:00:00,8,5,3,125,66,59,78,41,37,43,32
03-12-2020 15:00:00,11,7,4,145,71,74,57,17,40,70,38
03-12-2020 16:00:00,14,8,6,192,91,101,80,34,46,90,35
03-12-2020 17:00:00,13,9,4,256,136,120,118,47,71,157,24
03-12-2020 18:00:00,7,1,6,228,115,113,102,43,59,136,34
03-12-2020 19:00:00,10,6,4,169,78,91,57,29,28,88,23
03-12-2020 20:00:00,5,2,3,122,79,43,44,22,22,61,20
03-12-2020 21:00:00,5,2,3,73,46,27,38,17,21,47,10
03-12-2020 22:00:00,1,0,1,46,27,19,30,13,17,38,7
03-12-2020 23:00:00,1,0,1,36,24,12,9,2,7,19,5
04-12-2020 00:00:00,0,0,0,12,6,6,4,3,1,7,2
04-12-2020 01:00:00,0,0,0,1,1,0,4,3,1,2,1
04-12-2020 02:00:00,0,0,0,4,4,0,0,0,0,1,1
04-12-2020 03:00:00,0,0,0,7,4,3,1,1,0,3,0
04-12-2020 04:00:00,2,2,0,9,3,6,2,1,1,1,4
04-12-2020 05:00:00,1,0,1,23,2,21,13,11,2,5,17
04-12-2020 06:00:00,5,2,3,81,12,69,81,72,9,19,62
04-12-2020 07:00:00,11,11,0,155,39,116,80,71,9,23,73
04-12-2020 08:00:00,25,22,3,255,72,183,131,116,15,35,128
04-12-2020 09:00:00,16,13,3,114,19,95,91,74,17,25,60
04-12-2020 10:00:00,5,2,3,80,25,55,40,32,8,17,40
04-12-2020 11:00:00,16,12,4,91,29,62,42,35,7,27,29
04-12-2020 12:00:00,11,5,6,126,52,74,47,30,17,44,32
04-12-2020 13:00:00,12,8,4,120,50,70,66,32,34,52,12
04-12-2020 14:00:00,9,2,7,110,56,54,56,27,29,42,28
04-12-2020 15:00:00,10,7,3,162,73,89,51,30,21,81,34
04-12-2020 16:00:00,9,2,7,153,86,67,65,32,33,75,36
04-12-2020 17:00:00,14,4,10,213,105,108,83,35,48,105,29
04-12-2020 18:00:00,10,5,5,168,77,91,67,34,33,85,18
04-12-2020 19:00:00,7,3,4,148,68,80,49,24,25,60,19
04-12-2020 20:00:00,5,2,3,113,56,57,45,28,17,41,16
04-12-2020 21:00:00,5,1,4,68,36,32,32,9,23,24,5
04-12-2020 22:00:00,4,1,3,44,31,13,41,15,26,27,7
04-12-2020 23:00:00,1,1,0,42,32,10,13,6,7,21,4
05-12-2020 00:00:00,0,0,0,31,25,6,7,2,5,22,4
05-12-2020 01:00:00,1,0,1,12,6,6,5,1,4,7,2
05-12-2020 02:00:00,0,0,0,4,3,1,1,1,0,2,0
05-12-2020 03:00:00,0,0,0,7,2,5,1,1,0,3,0
05-12-2020 04:00:00,0,0,0,7,6,1,0,0,0,2,3
05-12-2020 05:00:00,0,0,0,7,1,6,5,4,1,1,5
05-12-2020 06:00:00,1,1,0,29,5,24,15,14,1,11,14
05-12-2020 07:00:00,2,0,2,42,13,29,43,36,7,7,20
05-12-2020 08:00:00,3,3,0,63,21,42,27,23,4,10,18
05-12-2020 09:00:00,10,6,4,77,27,50,28,21,7,21,34
05-12-2020 10:00:00,4,1,3,79,28,51,40,28,12,30,33
05-12-2020 11:00:00,8,6,2,102,34,68,40,30,10,39,26
05-12-2020 12:00:00,11,6,5,117,49,68,48,33,15,44,38
05-12-2020 13:00:00,10,7,3,126,49,77,62,35,27,55,46
05-12-2020 14:00:00,15,9,6,105,38,67,49,33,16,48,21
05-12-2020 15:00:00,9,5,4,132,44,88,50,31,19,63,32
05-12-2020 16:00:00,3,1,2,129,44,85,55,34,21,61,40
05-12-2020 17:00:00,3,2,1,104,36,68,32,16,16,65,26
05-12-2020 18:00:00,10,8,2,129,62,67,36,27,9,50,32
05-12-2020 19:00:00,3,1,2,109,47,62,48,30,18,45,27
05-12-2020 20:00:00,4,3,1,85,46,39,30,14,16,37,22
05-12-2020 21:00:00,5,2,3,57,32,25,28,17,11,28,14
05-12-2020 22:00:00,3,1,2,48,24,24,26,7,19,32,7
05-12-2020 23:00:00,1,0,1,47,34,13,16,5,11,24,9
06-12-2020 00:00:00,1,1,0,41,32,9,16,4,12,29,5
06-12-2020 01:00:00,0,0,0,26,18,8,6,0,6,11,3
06-12-2020 02:00:00,0,0,0,10,7,3,2,2,0,6,3
06-12-2020 03:00:00,0,0,0,8,5,3,1,0,1,8,2
06-12-2020 04:00:00,0,0,0,6,3,3,1,1,0,2,2
06-12-2020 05:00:00,0,0,0,11,5,6,1,1,0,2,4
06-12-2020 06:00:00,1,1,0,26,7,19,10,9,1,8,9
06-12-2020 07:00:00,1,1,0,24,7,17,16,16,0,9,20
06-12-2020 08:00:00,3,2,1,41,12,29,22,20,2,18,16
06-12-2020 09:00:00,3,2,1,51,20,31,34,26,8,26,25
06-12-2020 10:00:00,5,3,2,73,27,46,50,35,15,14,21
06-12-2020 11:00:00,2,1,1,78,28,50,46,30,16,44,46
06-12-2020 12:00:00,11,6,5,88,26,62,56,34,22,41,45
06-12-2020 13:00:00,4,1,3,99,40,59,47,25,22,41,35
06-12-2020 14:00:00,12,5,7,95,38,57,52,25,27,42,47
06-12-2020 15:00:00,7,4,3,86,38,48,54,29,25,42,53
06-12-2020 16:00:00,2,0,2,99,47,52,28,12,16,34,17
06-12-2020 17:00:00,4,3,1,80,42,38,42,22,20,44,7
06-12-2020 18:00:00,1,1,0,75,41,34,38,19,19,39,11
06-12-2020 19:00:00,4,1,3,74,43,31,21,12,9,27,15
06-12-2020 20:00:00,1,1,0,62,33,29,19,12,7,14,10
06-12-2020 21:00:00,2,1,1,28,16,12,20,7,13,31,6
06-12-2020 22:00:00,3,3,0,29,20,9,15,4,11,21,6
06-12-2020 23:00:00,0,0,0,23,14,9,4,0,4,16,2
07-12-2020 00:00:00,1,0,1,17,14,3,4,2,2,6,1
07-12-2020 01:00:00,0,0,0,7,7,0,0,0,0,5,0
07-12-2020 02:00:00,0,0,0,3,1,2,0,0,0,2,0
07-12-2020 03:00:00,0,0,0,7,4,3,0,0,0,2,1
07-12-2020 04:00:00,0,0,0,4,0,4,4,4,0,0,5
07-12-2020 05:00:00,1,0,1,26,4,22,13,11,2,2,9
07-12-2020 06:00:00,2,2,0,60,11,49,62,55,7,11,40
07-12-2020 07:00:00,5,4,1,166,43,123,76,68,8,14,65
07-12-2020 08:00:00,16,14,2,215,53,162,117,109,8,33,136
07-12-2020 09:00:00,9,8,1,112,25,87,56,45,11,23,84
07-12-2020 10:00:00,6,4,2,58,15,43,21,16,5,12,14
07-12-2020 11:00:00,10,5,5,57,20,37,55,42,13,14,16
07-12-2020 12:00:00,9,5,4,109,36,73,44,30,14,31,44
07-12-2020 13:00:00,9,4,5,127,50,77,57,37,20,42,37
07-12-2020 14:00:00,6,4,2,102,42,60,48,25,23,52,27
07-12-2020 15:00:00,9,4,5,123,63,60,53,28,25,38,27
07-12-2020 16:00:00,12,8,4,176,78,98,64,21,43,106,43
07-12-2020 17:00:00,5,3,2,233,119,114,99,40,59,154,36
07-12-2020 18:00:00,13,7,6,202,98,104,80,28,52,131,8
07-12-2020 19:00:00,5,2,3,114,70,44,43,26,17,64,9
07-12-2020 20:00:00,6,2,4,85,53,32,28,13,15,43,14
07-12-2020 21:00:00,4,3,1,67,41,26,26,10,16,25,10
07-12-2020 22:00:00,1,0,1,41,24,17,21,9,12,27,2
07-12-2020 23:00:00,2,2,0,25,22,3,13,5,8,13,0
08-12-2020 00:00:00,1,1,0,9,6,3,0,0,0,5,1
08-12-2020 01:00:00,0,0,0,2,2,0,1,1,0,1,1
08-12-2020 02:00:00,0,0,0,0,0,0,0,0,0,1,0
08-12-2020 03:00:00,0,0,0,5,3,2,0,0,0,0,1
08-12-2020 04:00:00,0,0,0,5,1,4,2,2,0,0,5
08-12-2020 05:00:00,1,1,0,28,5,23,12,9,3,3,12
08-12-2020 06:00:00,6,6,0,67,9,58,61,54,7,10,47
08-12-2020 07:00:00,11,9,2,166,49,117,99,84,15,25,77
08-12-2020 08:00:00,22,18,4,266,74,192,138,129,9,38,125
08-12-2020 09:00:00,8,5,3,133,21,112,76,63,13,23,49
08-12-2020 10:00:00,9,8,1,82,22,60,26,20,6,14,41
08-12-2020 11:00:00,6,3,3,101,36,65,42,27,15,8,19
08-12-2020 12:00:00,6,4,2,115,44,71,55,32,23,43,26
08-12-2020 13:00:00,9,4,5,116,56,60,50,31,19,54,37
08-12-2020 14:00:00,13,5,8,122,54,68,56,33,23,57,38
08-12-2020 15:00:00,8,5,3,122,51,71,62,26,36,50,37
08-12-2020 16:00:00,10,5,5,183,82,101,84,31,53,111,46
08-12-2020 17:00:00,12,7,5,280,150,130,108,43,65,127,52
08-12-2020 18:00:00,11,5,6,206,99,107,99,42,57,127,28
08-12-2020 19:00:00,7,3,4,177,66,111,55,25,30,74,30
08-12-2020 20:00:00,6,1,5,110,52,58,33,9,24,45,19
08-12-2020 21:00:00,5,1,4,57,36,21,20,10,10,39,12
08-12-2020 22:00:00,3,3,0,47,36,11,23,10,13,33,4
08-12-2020 23:00:00,2,1,1,32,25,7,14,4,10,22,3
09-12-2020 00:00:00,1,1,0,10,6,4,8,2,6,11,2
09-12-2020 01:00:00,0,0,0,6,3,3,2,1,1,2,0
09-12-2020 02:00:00,0,0,0,1,0,1,0,0,0,1,0
09-12-2020 03:00:00,1,1,0,4,2,2,1,1,0,0,0
09-12-2020 04:00:00,0,0,0,7,4,3,0,0,0,1,3
09-12-2020 05:00:00,1,1,0,27,5,22,14,12,2,4,14
09-12-2020 06:00:00,2,2,0,78,15,63,71,61,10,11,46
09-12-2020 07:00:00,12,11,1,170,45,125,105,89,16,22,100
09-12-2020 08:00:00,23,16,7,268,68,200,137,123,14,36,115
09-12-2020 09:00:00,14,12,2,131,28,103,72,57,15,16,54
09-12-2020 10:00:00,7,4,3,78,22,56,40,28,12,16,27
09-12-2020 11:00:00,7,5,2,99,30,69,48,38,10,22,45
09-12-2020 12:00:00,12,9,3,111,45,66,52,33,19,38,43
09-12-2020 13:00:00,4,2,2,143,68,75,54,29,25,53,35
09-12-2020 14:00:00,8,5,3,128,60,68,41,23,18,48,15
09-12-2020 15:00:00,6,4,2,97,44,53,39,12,27,43,11
09-12-2020 16:00:00,9,3,6,165,73,92,61,25,36,101,34
09-12-2020 17:00:00,9,2,7,181,129,52,104,35,69,141,18
09-12-2020 18:00:00,7,3,4,198,98,100,64,28,36,114,14
09-12-2020 19:00:00,4,0,4,129,71,58,38,16,22,64,17
09-12-2020 20:00:00,7,4,3,67,44,23,30,11,19,48,7
09-12-2020 21:00:00,5,3,2,37,23,14,24,9,15,29,3
09-12-2020 22:00:00,0,0,0,34,25,9,30,11,19,26,7
09-12-2020 23:00:00,0,0,0,26,23,3,8,1,7,14,6
10-12-2020 00:00:00,0,0,0,15,10,5,7,4,3,13,1
10-12-2020 01:00:00,1,1,0,9,8,1,1,1,0,2,2
10-12-2020 02:00:00,2,0,2,3,0,3,2,0,2,3,0
10-12-2020 03:00:00,0,0,0,5,3,2,1,1,0,0,0
10-12-2020 04:00:00,0,0,0,6,1,5,0,0,0,1,1
10-12-2020 05:00:00,0,0,0,27,6,21,8,5,3,3,7
10-12-2020 06:00:00,7,6,1,78,23,55,68,63,5,11,34
10-12-2020 07:00:00,9,7,2,166,56,110,93,76,17,23,74
10-12-2020 08:00:00,31,24,7,244,55,189,134,125,9,39,134
10-12-2020 09:00:00,8,8,0,157,35,122,75,62,13,14,43
10-12-2020 10:00:00,4,2,2,81,29,52,48,33,15,14,33
10-12-2020 11:00:00,9,7,2,82,25,57,55,44,11,16,19
10-12-2020 12:00:00,10,7,3,139,51,88,60,36,24,42,23
10-12-2020 13:00:00,10,2,8,143,45,98,73,42,31,57,37
10-12-2020 14:00:00,9,7,2,143,68,75,58,38,20,30,17
10-12-2020 15:00:00,8,5,3,161,66,95,52,24,28,67,31
10-12-2020 16:00:00,15,5,10,170,81,89,79,32,47,90,28
10-12-2020 17:00:00,8,4,4,204,113,91,89,36,53,117,8
10-12-2020 18:00:00,8,5,3,203,94,109,57,20,37,120,11
10-12-2020 19:00:00,9,5,4,146,55,91,46,18,28,76,13
10-12-2020 20:00:00,5,1,4,92,52,40,33,16,17,38,13
10-12-2020 21:00:00,3,1,2,53,33,20,20,11,9,32,19
10-12-2020 22:00:00,3,0,3,51,29,22,24,11,13,30,9
10-12-2020 23:00:00,0,0,0,35,27,8,16,5,11,28,3
11-12-2020 00:00:00,0,0,0,34,23,11,6,1,5,16,5
11-12-2020 01:00:00,0,0,0,9,8,1,2,0,2,6,1
11-12-2020 02:00:00,0,0,0,12,8,4,1,0,1,2,0
11-12-2020 03:00:00,0,0,0,8,4,4,1,1,0,1,0
11-12-2020 04:00:00,0,0,0,8,3,5,4,2,2,1,7
11-12-2020 05:00:00,2,2,0,26,3,23,13,12,1,2,5
11-12-2020 06:00:00,5,4,1,68,13,55,71,64,7,12,42
11-12-2020 07:00:00,11,7,4,185,54,131,102,88,14,21,87
11-12-2020 08:00:00,22,19,3,235,59,176,111,102,9,31,122
11-12-2020 09:00:00,8,6,2,139,32,107,82,64,18,19,71
11-12-2020 10:00:00,9,5,4,84,24,60,52,36,16,16,23
11-12-2020 11:00:00,11,8,3,119,41,78,52,39,13,18,26
11-12-2020 12:00:00,12,8,4,134,48,86,73,45,28,46,62
11-12-2020 13:00:00,12,8,4,162,78,84,68,35,33,68,63
11-12-2020 14:00:00,10,5,5,141,60,81,59,32,27,66,54
11-12-2020 15:00:00,8,5,3,162,73,89,71,38,33,102,31
11-12-2020 16:00:00,16,8,8,200,87,113,82,33,49,92,30
11-12-2020 17:00:00,10,5,5,280,165,115,108,44,64,149,37
11-12-2020 18:00:00,4,3,1,197,102,95,67,42,25,117,46
11-12-2020 19:00:00,13,5,8,174,69,105,49,25,24,66,25
11-12-2020 20:00:00,9,3,6,111,55,56,53,28,25,50,18
11-12-2020 21:00:00,2,1,1,86,51,35,25,11,14,42,15
11-12-2020 22:00:00,8,6,2,59,37,22,34,13,21,35,7
11-12-2020 23:00:00,2,1,1,54,43,11,20,9,11,37,12
12-12-2020 00:00:00,2,1,1,38,30,8,16,6,10,23,4
12-12-2020 01:00:00,1,0,1,18,11,7,6,2,4,17,6
12-12-2020 02:00:00,0,0,0,13,9,4,1,0,1,6,0
12-12-2020 03:00:00,0,0,0,11,6,5,1,0,1,5,1
12-12-2020 04:00:00,0,0,0,8,3,5,0,0,0,1,1
12-12-2020 05:00:00,2,2,0,16,2,14,5,4,1,3,3
12-12-2020 06:00:00,1,1,0,25,3,22,16,13,3,10,9
12-12-2020 07:00:00,4,2,2,59,12,47,52,46,6,9,38
12-12-2020 08:00:00,7,6,1,67,20,47,43,27,16,18,36
12-12-2020 09:00:00,17,13,4,86,28,58,52,35,17,27,47
12-12-2020 10:00:00,17,13,4,112,35,77,50,37,13,31,41
12-12-2020 11:00:00,1,1,0,150,45,105,75,50,25,51,53
12-12-2020 12:00:00,13,9,4,143,58,85,83,48,35,66,60
12-12-2020 13:00:00,20,8,12,177,73,104,77,38,39,83,68
12-12-2020 14:00:00,12,6,6,156,59,97,74,43,31,77,59
12-12-2020 15:00:00,9,3,6,163,64,99,85,49,36,58,56
12-12-2020 16:00:00,8,5,3,138,57,81,60,32,28,67,64
12-12-2020 17:00:00,10,5,5,111,61,50,48,29,19,72,38
12-12-2020 18:00:00,3,1,2,119,67,52,46,28,18,57,19
12-12-2020 19:00:00,5,3,2,86,45,41,44,24,20,46,36
12-12-2020 20:00:00,4,2,2,72,37,35,33,16,17,37,25
12-12-2020 21:00:00,5,2,3,64,39,25,37,17,20,27,10
12-12-2020 22:00:00,8,3,5,34,22,12,26,12,14,36,9
12-12-2020 23:00:00,0,0,0,42,29,13,19,5,14,28,10
13-12-2020 00:00:00,3,0,3,34,26,8,14,8,6,21,8
13-12-2020 01:00:00,0,0,0,20,17,3,2,0,2,14,2
13-12-2020 02:00:00,0,0,0,7,7,0,2,1,1,7,1
13-12-2020 03:00:00,1,0,1,6,3,3,1,1,0,2,0
13-12-2020 04:00:00,0,0,0,7,1,6,2,1,1,2,2
13-12-2020 05:00:00,0,0,0,9,0,9,1,0,1,4,1
13-12-2020 06:00:00,2,2,0,16,6,10,10,8,2,8,6
13-12-2020 07:00:00,1,0,1,38,10,28,15,14,1,11,17
13-12-2020 08:00:00,1,1,0,32,11,21,12,11,1,10,7
13-12-2020 09:00:00,3,3,0,39,15,24,11,8,3,7,9
13-12-2020 10:00:00,7,4,3,39,11,28,14,8,6,14,12
13-12-2020 11:00:00,2,1,1,43,13,30,18,11,7,15,7
13-12-2020 12:00:00,2,1,1,93,37,56,35,24,11,35,31
13-12-2020 13:00:00,8,5,3,120,50,70,47,28,19,39,26
13-12-2020 14:00:00,12,4,8,110,38,72,46,32,14,39,34
13-12-2020 15:00:00,6,4,2,101,42,59,52,29,23,46,36
13-12-2020 16:00:00,10,5,5,109,60,49,46,23,23,44,48
13-12-2020 17:00:00,4,3,1,100,41,59,39,24,15,43,34
13-12-2020 18:00:00,0,0,0,81,45,36,24,16,8,54,22
13-12-2020 19:00:00,6,3,3,92,52,40,44,25,19,49,19
13-12-2020 20:00:00,2,2,0,64,34,30,31,20,11,28,8
13-12-2020 21:00:00,4,1,3,40,24,16,13,6,7,25,8
13-12-2020 22:00:00,1,1,0,27,19,8,26,9,17,22,5
13-12-2020 23:00:00,2,1,1,19,14,5,8,4,4,15,1
14-12-2020 00:00:00,0,0,0,19,15,4,3,3,0,8,1
14-12-2020 01:00:00,0,0,0,6,5,1,2,1,1,2,1
14-12-2020 02:00:00,0,0,0,1,1,0,0,0,0,4,0
14-12-2020 03:00:00,0,0,0,8,6,2,1,0,1,1,3
14-12-2020 04:00:00,1,1,0,7,1,6,0,0,0,0,4
14-12-2020 05:00:00,2,2,0,21,4,17,13,12,1,3,21
14-12-2020 06:00:00,5,5,0,68,11,57,74,67,7,11,69
14-12-2020 07:00:00,11,11,0,175,45,130,106,97,9,28,97
14-12-2020 08:00:00,33,29,4,260,67,193,142,133,9,29,161
14-12-2020 09:00:00,12,6,6,149,33,116,68,46,22,28,75
14-12-2020 10:00:00,3,1,2,80,27,53,34,24,10,15,39
14-12-2020 11:00:00,8,6,2,100,23,77,36,29,7,27,45
14-12-2020 12:00:00,11,7,4,107,46,61,56,37,19,36,33
14-12-2020 13:00:00,6,3,3,112,52,60,60,31,29,48,40
14-12-2020 14:00:00,10,4,6,123,54,69,55,33,22,59,45
14-12-2020 15:00:00,14,10,4,140,66,74,72,29,43,78,40
14-12-2020 16:00:00,9,4,5,162,79,83,79,26,53,118,60
14-12-2020 17:00:00,17,7,10,249,138,111,112,47,65,156,43
14-12-2020 18:00:00,7,2,5,240,118,122,75,23,52,130,33
14-12-2020 19:00:00,4,2,2,101,53,48,53,29,24,72,15
14-12-2020 20:00:00,1,0,1,100,64,36,42,17,25,53,16
14-12-2020 21:00:00,8,2,6,59,40,19,30,10,20,35,14
14-12-2020 22:00:00,2,0,2,42,29,13,14,5,9,24,13
14-12-2020 23:00:00,1,1,0,25,15,10,9,0,9,25,4
15-12-2020 00:00:00,0,0,0,17,13,4,3,2,1,11,3
15-12-2020 01:00:00,1,1,0,6,3,3,2,1,1,7,0
15-12-2020 02:00:00,1,0,1,2,2,0,0,0,0,3,0
15-12-2020 03:00:00,0,0,0,6,3,3,0,0,0,2,2
15-12-2020 04:00:00,1,0,1,11,3,8,2,1,1,1,3
15-12-2020 05:00:00,1,1,0,25,4,21,9,8,1,4,13
15-12-2020 06:00:00,6,6,0,82,17,65,73,66,7,15,58
15-12-2020 07:00:00,16,14,2,192,53,139,111,94,17,21,103
15-12-2020 08:00:00,28,25,3,279,72,207,154,136,18,40,161
15-12-2020 09:00:00,10,5,5,143,17,126,78,60,18,17,71
15-12-2020 10:00:00,10,7,3,77,29,48,27,18,9,17,41
15-12-2020 11:00:00,7,2,5,106,37,69,55,42,13,28,24
15-12-2020 12:00:00,13,9,4,141,49,92,56,36,20,59,40
15-12-2020 13:00:00,10,8,2,113,53,60,59,38,21,67,53
15-12-2020 14:00:00,14,7,7,124,50,74,48,28,20,61,48
15-12-2020 15:00:00,14,8,6,166,78,88,68,27,41,88,50
15-12-2020 16:00:00,10,4,6,212,105,107,76,31,45,118,49
15-12-2020 17:00:00,13,8,5,254,140,114,115,46,69,175,45
15-12-2020 18:00:00,13,6,7,229,128,101,98,41,57,126,36
15-12-2020 19:00:00,7,2,5,132,65,67,57,22,35,91,22
15-12-2020 20:00:00,6,2,4,103,59,44,35,11,24,62,20
15-12-2020 21:00:00,2,1,1,56,38,18,33,13,20,38,26
15-12-2020 22:00:00,3,2,1,45,31,14,27,12,15,39,9
15-12-2020 23:00:00,1,1,0,32,25,7,12,4,8,17,4
16-12-2020 00:00:00,1,1,0,9,6,3,5,3,2,11,4
16-12-2020 01:00:00,0,0,0,10,8,2,2,1,1,9,1
16-12-2020 02:00:00,1,0,1,3,1,2,0,0,0,1,0
16-12-2020 03:00:00,0,0,0,3,1,2,0,0,0,0,1
16-12-2020 04:00:00,0,0,0,8,1,7,1,1,0,0,3
16-12-2020 05:00:00,1,1,0,20,3,17,10,9,1,4,11
16-12-2020 06:00:00,4,4,0,80,12,68,72,68,4,11,49
16-12-2020 07:00:00,6,6,0,172,42,130,103,85,18,22,89
16-12-2020 08:00:00,19,17,2,237,54,183,123,110,13,30,124
16-12-2020 09:00:00,16,13,3,117,26,91,73,60,13,26,63
16-12-2020 10:00:00,8,7,1,78,18,60,29,24,5,14,29
16-12-2020 11:00:00,11,6,5,76,25,51,48,36,12,22,34
16-12-2020 12:00:00,12,6,6,92,38,54,46,30,16,42,45
16-12-2020 13:00:00,8,3,5,140,61,79,60,32,28,46,28
16-12-2020 14:00:00,13,8,5,119,46,73,68,38,30,55,25
16-12-2020 15:00:00,6,3,3,127,57,70,46,22,24,50,31
16-12-2020 16:00:00,6,4,2,172,78,94,67,30,37,88,36
16-12-2020 17:00:00,15,6,9,213,118,95,91,34,57,146,15
16-12-2020 18:00:00,9,3,6,217,102,115,85,32,53,123,24
16-12-2020 19:00:00,6,6,0,170,72,98,54,30,24,77,27
16-12-2020 20:00:00,2,0,2,113,62,51,39,28,11,47,33
16-12-2020 21:00:00,8,3,5,57,31,26,35,9,26,39,20
16-12-2020 22:00:00,2,1,1,46,28,18,30,9,21,24,12
16-12-2020 23:00:00,1,0,1,43,33,10,10,3,7,22,6
17-12-2020 00:00:00,0,0,0,25,18,7,9,4,5,13,2
17-12-2020 01:00:00,0,0,0,4,3,1,3,1,2,5,0
17-12-2020 02:00:00,0,0,0,8,4,4,1,1,0,2,2
17-12-2020 03:00:00,0,0,0,6,3,3,2,1,1,4,0
17-12-2020 04:00:00,0,0,0,6,0,6,3,3,0,2,6
17-12-2020 05:00:00,1,1,0,22,2,20,9,7,2,1,13
17-12-2020 06:00:00,5,5,0,73,15,58,72,67,5,13,46
17-12-2020 07:00:00,15,12,3,174,45,129,97,83,14,24,97
17-12-2020 08:00:00,36,28,8,259,78,181,131,116,15,35,152
17-12-2020 09:00:00,16,12,4,126,25,101,73,62,11,22,74
17-12-2020 10:00:00,11,9,2,75,29,46,48,38,10,21,45
17-12-2020 11:00:00,7,5,2,108,40,68,58,45,13,24,46
17-12-2020 12:00:00,13,8,5,148,60,88,59,36,23,50,58
17-12-2020 13:00:00,6,3,3,137,57,80,55,34,21,76,52
17-12-2020 14:00:00,11,9,2,157,83,74,58,36,22,55,34
17-12-2020 15:00:00,10,6,4,150,77,73,66,27,39,65,35
17-12-2020 16:00:00,12,7,5,177,77,100,74,31,43,94,41
17-12-2020 17:00:00,12,7,5,240,130,110,100,47,53,130,34
17-12-2020 18:00:00,8,2,6,211,99,112,79,28,51,127,36
17-12-2020 19:00:00,5,1,4,171,72,99,54,18,36,75,39
17-12-2020 20:00:00,3,2,1,145,70,75,41,19,22,60,33
17-12-2020 21:00:00,4,2,2,56,37,19,24,11,13,32,16
17-12-2020 22:00:00,1,1,0,41,27,14,24,8,16,33,10
17-12-2020 23:00:00,1,0,1,36,31,5,22,9,13,27,5
18-12-2020 00:00:00,2,2,0,28,21,7,6,2,4,18,2
18-12-2020 01:00:00,2,0,2,13,12,1,4,2,2,6,4
18-12-2020 02:00:00,0,0,0,3,2,1,1,1,0,2,1
18-12-2020 03:00:00,0,0,0,7,4,3,1,1,0,3,2
18-12-2020 04:00:00,0,0,0,6,2,4,1,1,0,3,2
18-12-2020 05:00:00,2,2,0,20,2,18,15,14,1,1,15
18-12-2020 06:00:00,6,4,2,67,9,58,67,63,4,15,55
18-12-2020 07:00:00,6,5,1,151,36,115,77,63,14,20,82
18-12-2020 08:00:00,27,25,2,221,58,163,101,93,8,30,95
18-12-2020 09:00:00,8,5,3,125,33,92,69,51,18,16,65
18-12-2020 10:00:00,5,4,1,89,29,60,44,34,10,25,26
18-12-2020 11:00:00,7,7,0,109,20,89,49,35,14,19,43
18-12-2020 12:00:00,10,6,4,119,47,72,74,50,24,46,49
18-12-2020 13:00:00,9,7,2,140,56,84,59,35,24,75,45
18-12-2020 14:00:00,15,9,6,123,60,63,67,42,25,63,47
18-12-2020 15:00:00,9,4,5,149,83,66,70,33,37,85,46
18-12-2020 16:00:00,12,7,5,184,95,89,82,43,39,93,29
18-12-2020 17:00:00,12,4,8,227,112,115,86,37,49,134,28
18-12-2020 18:00:00,6,2,4,179,86,93,59,30,29,101,38
18-12-2020 19:00:00,4,1,3,160,69,91,51,22,29,70,22
18-12-2020 20:00:00,2,2,0,155,67,88,36,15,21,41,13
18-12-2020 21:00:00,2,1,1,74,40,34,25,12,13,30,10
18-12-2020 22:00:00,5,3,2,41,23,18,23,8,15,37,7
18-12-2020 23:00:00,3,1,2,35,24,11,15,3,12,26,9
19-12-2020 00:00:00,1,1,0,34,27,7,18,9,9,19,4
19-12-2020 01:00:00,2,2,0,22,17,5,4,2,2,11,4
19-12-2020 02:00:00,0,0,0,13,8,5,1,0,1,2,1
19-12-2020 03:00:00,0,0,0,9,6,3,0,0,0,2,2
19-12-2020 04:00:00,0,0,0,8,5,3,2,2,0,1,1
19-12-2020 05:00:00,1,1,0,13,5,8,2,2,0,3,5
19-12-2020 06:00:00,0,0,0,44,5,39,17,13,4,8,7
19-12-2020 07:00:00,1,0,1,44,16,28,27,22,5,17,25
19-12-2020 08:00:00,3,3,0,54,22,32,28,19,9,13,34
19-12-2020 09:00:00,13,7,6,66,15,51,36,26,10,21,33
19-12-2020 10:00:00,5,1,4,73,22,51,47,35,12,22,32
19-12-2020 11:00:00,10,5,5,120,45,75,51,34,17,47,36
19-12-2020 12:00:00,16,12,4,116,46,70,62,40,22,60,61
19-12-2020 13:00:00,16,9,7,111,50,61,50,26,24,51,61
19-12-2020 14:00:00,7,4,3,119,46,73,53,26,27,65,17
19-12-2020 15:00:00,12,7,5,121,46,75,60,43,17,50,30
19-12-2020 16:00:00,7,2,5,137,69,68,49,29,20,46,20
19-12-2020 17:00:00,2,2,0,86,42,44,34,21,13,47,22
19-12-2020 18:00:00,6,3,3,97,56,41,35,18,17,53,21
19-12-2020 19:00:00,2,1,1,88,41,47,31,21,10,44,20
19-12-2020 20:00:00,5,4,1,64,28,36,37,25,12,32,13
19-12-2020 21:00:00,9,6,3,57,39,18,29,14,15,29,18
19-12-2020 22:00:00,11,7,4,40,20,20,21,9,12,34,15
19-12-2020 23:00:00,3,2,1,45,27,18,24,8,16,34,5
20-12-2020 00:00:00,0,0,0,34,22,12,10,3,7,20,3
20-12-2020 01:00:00,0,0,0,13,11,2,3,3,0,5,4
20-12-2020 02:00:00,1,1,0,13,9,4,1,1,0,10,3
20-12-2020 03:00:00,2,0,2,8,6,2,0,0,0,3,2
20-12-2020 04:00:00,0,0,0,2,2,0,2,2,0,2,3
20-12-2020 05:00:00,0,0,0,7,1,6,0,0,0,5,4
20-12-2020 06:00:00,2,2,0,21,5,16,9,8,1,8,5
20-12-2020 07:00:00,1,1,0,27,7,20,17,14,3,7,21
20-12-2020 08:00:00,1,1,0,49,19,30,21,18,3,10,17
20-12-2020 09:00:00,9,6,3,50,18,32,34,25,9,14,18
20-12-2020 10:00:00,12,2,10,73,32,41,38,28,10,20,47
20-12-2020 11:00:00,6,4,2,95,28,67,57,35,22,40,39
20-12-2020 12:00:00,16,11,5,117,52,65,57,33,24,51,50
20-12-2020 13:00:00,14,9,5,105,38,67,68,36,32,56,34
20-12-2020 14:00:00,10,4,6,111,47,64,47,24,23,61,57
20-12-2020 15:00:00,7,3,4,120,41,79,64,33,31,48,48
20-12-2020 16:00:00,5,2,3,115,51,64,48,30,18,50,19
20-12-2020 17:00:00,4,2,2,89,36,53,38,19,19,56,12
20-12-2020 18:00:00,1,0,1,100,46,54,41,20,21,52,14
20-12-2020 19:00:00,5,2,3,79,39,40,36,22,14,41,12
20-12-2020 20:00:00,4,3,1,85,45,40,26,13,13,29,14
20-12-2020 21:00:00,1,1,0,46,29,17,25,8,17,30,9
20-12-2020 22:00:00,3,2,1,37,20,17,22,8,14,38,4
20-12-2020 23:00:00,1,1,0,47,40,7,13,5,8,18,2
21-12-2020 00:00:00,1,1,0,14,9,5,8,2,6,9,1
21-12-2020 01:00:00,1,1,0,6,4,2,0,0,0,9,0
21-12-2020 02:00:00,1,1,0,4,3,1,1,1,0,3,1
21-12-2020 03:00:00,0,0,0,6,4,2,5,2,3,1,3
21-12-2020 04:00:00,0,0,0,6,1,5,2,2,0,2,2
21-12-2020 05:00:00,1,1,0,19,1,18,13,11,2,3,12
21-12-2020 06:00:00,5,5,0,60,11,49,45,44,1,10,35
21-12-2020 07:00:00,3,3,0,129,31,98,63,48,15,17,61
21-12-2020 08:00:00,26,20,6,177,48,129,85,75,10,19,102
21-12-2020 09:00:00,11,7,4,111,21,90,55,43,12,21,58
21-12-2020 10:00:00,6,4,2,73,19,54,30,22,8,12,41
21-12-2020 11:00:00,13,9,4,81,26,55,45,36,9,22,35
21-12-2020 12:00:00,4,3,1,105,32,73,45,30,15,39,39
21-12-2020 13:00:00,6,4,2,99,36,63,43,26,17,42,35
21-12-2020 14:00:00,6,4,2,100,52,48,54,33,21,50,31
21-12-2020 15:00:00,12,6,6,138,68,70,56,31,25,73,46
21-12-2020 16:00:00,4,0,4,167,75,92,57,30,27,99,49
21-12-2020 17:00:00,10,6,4,221,112,109,70,34,36,107,27
21-12-2020 18:00:00,9,4,5,134,77,57,53,20,33,79,14
21-12-2020 19:00:00,7,2,5,115,43,72,28,10,18,54,9
21-12-2020 20:00:00,4,4,0,54,33,21,22,9,13,27,19
21-12-2020 21:00:00,3,1,2,39,23,16,16,12,4,30,18
21-12-2020 22:00:00,2,1,1,24,9,15,14,7,7,24,8
21-12-2020 23:00:00,2,2,0,33,21,12,16,8,8,14,5
22-12-2020 00:00:00,0,0,0,22,17,5,4,1,3,8,5
22-12-2020 01:00:00,1,0,1,11,8,3,3,2,1,8,1
22-12-2020 02:00:00,0,0,0,2,1,1,0,0,0,2,1
22-12-2020 03:00:00,1,0,1,8,3,5,1,1,0,1,2
22-12-2020 04:00:00,0,0,0,5,0,5,1,1,0,3,1
22-12-2020 05:00:00,2,2,0,23,2,21,12,11,1,2,14
22-12-2020 06:00:00,6,6,0,60,11,49,47,41,6,14,41
22-12-2020 07:00:00,7,4,3,116,35,81,77,63,14,20,77
22-12-2020 08:00:00,18,13,5,205,65,140,86,76,10,21,104
22-12-2020 09:00:00,16,9,7,82,14,68,52,43,9,24,60
22-12-2020 10:00:00,6,6,0,80,17,63,36,21,15,24,46
22-12-2020 11:00:00,6,4,2,110,37,73,57,37,20,30,33
22-12-2020 12:00:00,6,4,2,148,74,74,57,36,21,57,38
22-12-2020 13:00:00,6,3,3,125,60,65,61,36,25,50,40
22-12-2020 14:00:00,5,1,4,140,61,79,47,26,21,57,42
22-12-2020 15:00:00,9,3,6,135,57,78,63,35,28,71,42
22-12-2020 16:00:00,5,4,1,170,73,97,50,25,25,93,42
22-12-2020 17:00:00,7,3,4,184,92,92,61,26,35,110,34
22-12-2020 18:00:00,3,0,3,137,70,67,50,21,29,99,20
22-12-2020 19:00:00,4,2,2,103,46,57,31,15,16,46,26
22-12-2020 20:00:00,3,1,2,92,47,45,29,16,13,41,19
22-12-2020 21:00:00,0,0,0,53,32,21,24,12,12,30,16
22-12-2020 22:00:00,4,2,2,39,25,14,16,6,10,23,5
22-12-2020 23:00:00,1,1,0,34,27,7,14,4,10,22,7
23-12-2020 00:00:00,0,0,0,20,17,3,7,1,6,7,6
23-12-2020 01:00:00,0,0,0,12,7,5,1,0,1,4,5
23-12-2020 02:00:00,0,0,0,1,1,0,0,0,0,2,1
23-12-2020 03:00:00,0,0,0,5,3,2,2,2,0,0,0
23-12-2020 04:00:00,0,0,0,6,0,6,0,0,0,0,3
23-12-2020 05:00:00,1,1,0,11,0,11,10,9,1,1,7
23-12-2020 06:00:00,2,1,1,48,6,42,25,22,3,8,27
23-12-2020 07:00:00,2,1,1,74,17,57,32,26,6,16,45
23-12-2020 08:00:00,7,7,0,104,29,75,44,41,3,10,59
23-12-2020 09:00:00,5,4,1,69,18,51,44,35,9,13,38
23-12-2020 10:00:00,5,4,1,56,19,37,22,14,8,23,30
23-12-2020 11:00:00,6,4,2,77,23,54,27,19,8,15,24
23-12-2020 12:00:00,5,2,3,98,35,63,35,22,13,28,25
23-12-2020 13:00:00,3,1,2,103,45,58,27,18,9,20,20
23-12-2020 14:00:00,4,4,0,71,24,47,20,7,13,30,16
23-12-2020 15:00:00,5,3,2,89,47,42,29,16,13,50,12
23-12-2020 16:00:00,9,3,6,143,51,92,46,23,23,54,10
23-12-2020 17:00:00,6,4,2,109,47,62,41,12,29,54,18
23-12-2020 18:00:00,0,0,0,102,53,49,28,14,14,59,11
23-12-2020 19:00:00,6,5,1,105,43,62,29,9,20,47,19
23-12-2020 20:00:00,5,3,2,71,37,34,27,16,11,31,7
23-12-2020 21:00:00,3,0,3,37,24,13,25,12,13,27,16
23-12-2020 22:00:00,3,2,1,34,17,17,23,6,17,28,11
23-12-2020 23:00:00,3,0,3,27,22,5,6,3,3,21,3
24-12-2020 00:00:00,3,1,2,24,16,8,6,1,5,8,3
24-12-2020 01:00:00,0,0,0,6,5,1,0,0,0,5,2
24-12-2020 02:00:00,1,0,1,2,0,2,3,1,2,1,2
24-12-2020 03:00:00,0,0,0,4,2,2,0,0,0,1,0
24-12-2020 04:00:00,0,0,0,8,3,5,3,2,1,1,3
24-12-2020 05:00:00,2,1,1,17,3,14,6,6,0,0,5
24-12-2020 06:00:00,3,3,0,21,4,17,22,20,2,9,13
24-12-2020 07:00:00,6,3,3,64,18,46,21,17,4,18,21
24-12-2020 08:00:00,4,3,1,58,17,41,25,23,2,16,32
24-12-2020 09:00:00,8,6,2,61,21,40,36,27,9,18,36
24-12-2020 10:00:00,5,4,1,69,19,50,35,20,15,31,33
24-12-2020 11:00:00,4,3,1,98,36,62,42,23,19,42,41
24-12-2020 12:00:00,7,4,3,111,51,60,35,14,21,65,31
24-12-2020 13:00:00,5,0,5,101,33,68,40,24,16,50,19
24-12-2020 14:00:00,3,2,1,99,43,56,35,17,18,40,32
24-12-2020 15:00:00,9,4,5,84,49,35,28,15,13,55,29
24-12-2020 16:00:00,3,2,1,63,32,31,21,11,10,50,19
24-12-2020 17:00:00,6,4,2,91,44,47,32,14,18,47,14
24-12-2020 18:00:00,3,2,1,56,25,31,26,14,12,21,10
24-12-2020 19:00:00,1,1,0,46,19,27,18,14,4,15,14
24-12-2020 20:00:00,1,1,0,38,21,17,11,6,5,11,4
24-12-2020 21:00:00,2,1,1,26,11,15,5,3,2,7,5
24-12-2020 22:00:00,0,0,0,15,6,9,13,6,7,8,7
24-12-2020 23:00:00,0,0,0,12,6,6,2,2,0,3,2
25-12-2020 00:00:00,0,0,0,4,3,1,5,4,1,3,1
25-12-2020 01:00:00,0,0,0,7,7,0,4,1,3,2,2
25-12-2020 02:00:00,1,1,0,2,2,0,2,1,1,2,1
25-12-2020 03:00:00,0,0,0,7,5,2,1,1,0,0,2
25-12-2020 04:00:00,0,0,0,6,5,1,3,1,2,2,0
25-12-2020 05:00:00,1,0,1,3,1,2,4,2,2,1,2
25-12-2020 06:00:00,0,0,0,3,2,1,3,1,2,0,3
25-12-2020 07:00:00,0,0,0,20,8,12,4,3,1,10,5
25-12-2020 08:00:00,2,1,1,8,6,2,5,1,4,12,3
25-12-2020 09:00:00,5,2,3,22,8,14,10,8,2,9,5
25-12-2020 10:00:00,2,0,2,19,7,12,9,4,5,8,14
25-12-2020 11:00:00,4,3,1,24,10,14,12,7,5,17,7
25-12-2020 12:00:00,3,1,2,34,18,16,16,10,6,19,15
25-12-2020 13:00:00,2,1,1,36,12,24,23,12,11,27,17
25-12-2020 14:00:00,6,1,5,35,21,14,14,10,4,18,12
25-12-2020 15:00:00,1,0,1,33,16,17,18,9,9,18,11
25-12-2020 16:00:00,3,1,2,18,13,5,13,9,4,9,11
25-12-2020 17:00:00,2,2,0,25,13,12,14,8,6,13,4
25-12-2020 18:00:00,2,1,1,23,11,12,13,9,4,9,7
25-12-2020 19:00:00,4,3,1,22,10,12,18,11,7,11,11
25-12-2020 20:00:00,0,0,0,16,6,10,7,6,1,10,4
25-12-2020 21:00:00,1,0,1,12,5,7,8,7,1,1,4
25-12-2020 22:00:00,4,3,1,9,5,4,7,4,3,4,5
25-12-2020 23:00:00,2,1,1,7,4,3,10,6,4,5,8
26-12-2020 00:00:00,0,0,0,2,0,2,7,3,4,5,1
26-12-2020 01:00:00,1,1,0,2,2,0,4,0,4,2,1
26-12-2020 02:00:00,0,0,0,1,0,1,0,0,0,2,1
26-12-2020 03:00:00,0,0,0,2,1,1,0,0,0,0,1
26-12-2020 04:00:00,0,0,0,0,0,0,1,0,1,0,0
26-12-2020 05:00:00,0,0,0,3,0,3,1,1,0,0,0
26-12-2020 06:00:00,0,0,0,4,1,3,3,1,2,1,2
26-12-2020 07:00:00,1,0,1,17,8,9,7,5,2,9,6
26-12-2020 08:00:00,0,0,0,12,5,7,6,5,1,7,10
26-12-2020 09:00:00,1,1,0,21,8,13,6,5,1,9,9
26-12-2020 10:00:00,4,3,1,22,8,14,9,6,3,17,10
26-12-2020 11:00:00,3,3,0,29,11,18,26,16,10,13,15
26-12-2020 12:00:00,6,3,3,36,16,20,28,20,8,19,22
26-12-2020 13:00:00,4,2,2,54,22,32,22,11,11,21,18
26-12-2020 14:00:00,3,1,2,33,12,21,36,28,8,21,19
26-12-2020 15:00:00,5,3,2,31,20,11,27,17,10,16,16
26-12-2020 16:00:00,5,4,1,33,13,20,12,8,4,26,16
26-12-2020 17:00:00,3,2,1,29,15,14,15,10,5,19,6
26-12-2020 18:00:00,2,2,0,38,16,22,8,7,1,9,5
26-12-2020 19:00:00,1,0,1,18,7,11,11,7,4,16,13
26-12-2020 20:00:00,3,3,0,13,8,5,10,9,1,10,5
26-12-2020 21:00:00,1,0,1,13,6,7,5,3,2,5,3
26-12-2020 22:00:00,0,0,0,13,7,6,2,1,1,5,2
26-12-2020 23:00:00,1,0,1,7,5,2,2,1,1,1,0
27-12-2020 00:00:00,0,0,0,4,2,2,4,2,2,1,1
27-12-2020 01:00:00,0,0,0,1,0,1,3,1,2,3,0
27-12-2020 02:00:00,0,0,0,0,0,0,1,1,0,0,0
27-12-2020 03:00:00,1,0,1,1,1,0,2,1,1,0,0
27-12-2020 04:00:00,0,0,0,5,2,3,1,1,0,1,3
27-12-2020 05:00:00,0,0,0,4,1,3,1,1,0,0,1
27-12-2020 06:00:00,0,0,0,9,3,6,10,8,2,8,5
27-12-2020 07:00:00,1,0,1,23,7,16,7,5,2,7,10
27-12-2020 08:00:00,1,1,0,26,9,17,14,13,1,8,12
27-12-2020 09:00:00,1,1,0,27,9,18,6,5,1,9,13
27-12-2020 10:00:00,3,2,1,36,12,24,19,13,6,10,14
27-12-2020 11:00:00,3,2,1,43,12,31,29,20,9,19,18
27-12-2020 12:00:00,9,6,3,67,24,43,45,22,23,43,32
27-12-2020 13:00:00,2,1,1,79,36,43,30,19,11,35,28
27-12-2020 14:00:00,18,10,8,65,32,33,47,24,23,37,25
27-12-2020 15:00:00,7,0,7,61,35,26,54,30,24,34,31
27-12-2020 16:00:00,3,1,2,57,26,31,24,13,11,39,20
27-12-2020 17:00:00,7,6,1,64,40,24,19,11,8,28,32
27-12-2020 18:00:00,2,0,2,61,27,34,25,19,6,42,18
27-12-2020 19:00:00,2,1,1,47,27,20,25,16,9,32,13
27-12-2020 20:00:00,4,3,1,52,33,19,22,11,11,19,13
27-12-2020 21:00:00,1,1,0,30,16,14,3,1,2,10,5
27-12-2020 22:00:00,1,1,0,12,6,6,5,1,4,3,4
27-12-2020 23:00:00,2,1,1,6,2,4,2,1,1,3,0
28-12-2020 00:00:00,1,1,0,8,2,6,6,5,1,2,4
28-12-2020 01:00:00,1,0,1,4,1,3,2,0,2,3,0
28-12-2020 02:00:00,0,0,0,1,0,1,1,1,0,0,0
28-12-2020 03:00:00,1,0,1,2,1,1,0,0,0,0,0
28-12-2020 04:00:00,0,0,0,6,1,5,1,1,0,1,2
28-12-2020 05:00:00,0,0,0,4,0,4,6,5,1,1,5
28-12-2020 06:00:00,0,0,0,12,2,10,11,9,2,7,6
28-12-2020 07:00:00,4,1,3,23,7,16,12,11,1,6,15
28-12-2020 08:00:00,1,1,0,25,10,15,9,7,2,10,13
28-12-2020 09:00:00,7,7,0,35,17,18,14,13,1,4,20
28-12-2020 10:00:00,7,5,2,30,11,19,15,12,3,15,16
28-12-2020 11:00:00,2,0,2,46,14,32,25,21,4,15,13
28-12-2020 12:00:00,4,0,4,44,20,24,23,11,12,16,15
28-12-2020 13:00:00,3,2,1,56,24,32,20,11,9,20,8
28-12-2020 14:00:00,4,3,1,47,20,27,23,14,9,20,15
28-12-2020 15:00:00,0,0,0,36,18,18,22,10,12,19,18
28-12-2020 16:00:00,9,3,6,56,31,25,23,15,8,28,12
28-12-2020 17:00:00,2,2,0,66,33,33,26,11,15,36,12
28-12-2020 18:00:00,1,1,0,57,32,25,28,21,7,52,15
28-12-2020 19:00:00,3,1,2,70,32,38,16,9,7,32,22
28-12-2020 20:00:00,5,2,3,33,20,13,29,16,13,23,7
28-12-2020 21:00:00,6,4,2,34,17,17,8,6,2,19,11
28-12-2020 22:00:00,4,1,3,18,9,9,6,1,5,12,9
28-12-2020 23:00:00,0,0,0,14,9,5,5,3,2,6,4
29-12-2020 00:00:00,0,0,0,7,5,2,3,2,1,4,1
29-12-2020 01:00:00,0,0,0,4,3,1,2,0,2,4,1
29-12-2020 02:00:00,0,0,0,0,0,0,0,0,0,1,0
29-12-2020 03:00:00,0,0,0,2,0,2,0,0,0,0,2
29-12-2020 04:00:00,0,0,0,9,3,6,1,1,0,0,3
29-12-2020 05:00:00,1,1,0,5,0,5,6,5,1,2,5
29-12-2020 06:00:00,1,1,0,20,5,15,18,17,1,7,10
29-12-2020 07:00:00,4,1,3,41,12,29,20,18,2,13,17
29-12-2020 08:00:00,7,6,1,57,28,29,21,18,3,11,30
29-12-2020 09:00:00,7,4,3,47,21,26,21,13,8,13,27
29-12-2020 10:00:00,4,2,2,59,20,39,39,29,10,25,30
29-12-2020 11:00:00,8,4,4,76,32,44,64,37,27,37,26
29-12-2020 12:00:00,7,5,2,108,47,61,55,30,25,49,41
29-12-2020 13:00:00,16,9,7,128,55,73,74,37,37,79,38
29-12-2020 14:00:00,13,5,8,106,47,59,63,34,29,54,58
29-12-2020 15:00:00,7,4,3,95,50,45,53,28,25,60,33
29-12-2020 16:00:00,4,2,2,99,41,58,31,19,12,52,29
29-12-2020 17:00:00,7,3,4,91,46,45,43,24,19,58,11
29-12-2020 18:00:00,6,3,3,78,46,32,29,18,11,52,19
29-12-2020 19:00:00,4,1,3,59,29,30,13,8,5,36,20
29-12-2020 20:00:00,3,1,2,62,31,31,25,17,8,26,10
29-12-2020 21:00:00,7,4,3,28,14,14,17,10,7,19,7
29-12-2020 22:00:00,2,1,1,32,20,12,7,2,5,13,5
29-12-2020 23:00:00,0,0,0,12,8,4,4,1,3,3,5
30-12-2020 00:00:00,0,0,0,5,2,3,4,1,3,8,4
30-12-2020 01:00:00,0,0,0,1,1,0,3,1,2,1,0
30-12-2020 02:00:00,0,0,0,1,0,1,1,1,0,4,3
30-12-2020 03:00:00,0,0,0,7,5,2,1,1,0,1,2
30-12-2020 04:00:00,0,0,0,6,2,4,1,1,0,0,1
30-12-2020 05:00:00,2,2,0,3,1,2,5,2,3,0,4
30-12-2020 06:00:00,3,3,0,19,4,15,18,15,3,10,17
30-12-2020 07:00:00,3,2,1,49,17,32,17,14,3,8,27
30-12-2020 08:00:00,7,7,0,61,22,39,27,22,5,12,47
30-12-2020 09:00:00,6,4,2,50,22,28,22,16,6,12,22
30-12-2020 10:00:00,3,2,1,44,15,29,25,17,8,17,27
30-12-2020 11:00:00,5,3,2,87,33,54,33,21,12,28,26
30-12-2020 12:00:00,5,4,1,69,30,39,33,22,11,43,43
30-12-2020 13:00:00,13,5,8,82,35,47,59,29,30,55,26
30-12-2020 14:00:00,11,4,7,104,47,57,54,29,25,55,51
30-12-2020 15:00:00,16,10,6,107,51,56,81,43,38,50,28
30-12-2020 16:00:00,8,4,4,91,48,43,38,19,19,48,16
30-12-2020 17:00:00,4,1,3,105,52,53,38,23,15,59,13
30-12-2020 18:00:00,6,3,3,76,44,32,39,23,16,60,7
30-12-2020 19:00:00,3,1,2,66,32,34,24,13,11,48,6
30-12-2020 20:00:00,2,1,1,50,27,23,24,16,8,19,9
30-12-2020 21:00:00,4,2,2,26,12,14,16,12,4,18,4
30-12-2020 22:00:00,3,3,0,28,18,10,14,7,7,15,2
30-12-2020 23:00:00,3,0,3,16,9,7,6,4,2,6,1
31-12-2020 00:00:00,1,1,0,9,5,4,3,2,1,7,0
31-12-2020 01:00:00,0,0,0,3,2,1,0,0,0,0,2
31-12-2020 02:00:00,0,0,0,1,0,1,0,0,0,2,1
31-12-2020 03:00:00,0,0,0,2,2,0,1,1,0,0,0
31-12-2020 04:00:00,0,0,0,6,2,4,1,1,0,1,4
31-12-2020 05:00:00,2,2,0,8,1,7,5,3,2,1,6
31-12-2020 06:00:00,0,0,0,20,5,15,15,11,4,9,4
31-12-2020 07:00:00,3,2,1,29,7,22,19,16,3,8,13
31-12-2020 08:00:00,1,1,0,39,17,22,14,13,1,9,24
31-12-2020 09:00:00,2,1,1,29,6,23,6,5,1,7,14
31-12-2020 10:00:00,4,4,0,47,22,25,21,13,8,17,15
31-12-2020 11:00:00,1,0,1,55,17,38,17,9,8,20,9
31-12-2020 12:00:00,5,2,3,54,26,28,27,15,12,21,23
31-12-2020 13:00:00,6,4,2,49,21,28,33,20,13,36,27
31-12-2020 14:00:00,4,2,2,55,25,30,32,22,10,37,18
31-12-2020 15:00:00,6,5,1,67,37,30,23,14,9,33,23
31-12-2020 16:00:00,2,1,1,58,25,33,31,18,13,36,15
31-12-2020 17:00:00,4,0,4,60,30,30,19,9,10,24,9
31-12-2020 18:00:00,8,4,4,48,26,22,24,18,6,21,15
31-12-2020 19:00:00,2,1,1,55,27,28,26,18,8,5,9
31-12-2020 20:00:00,0,0,0,34,14,20,13,6,7,11,2
31-12-2020 21:00:00,3,1,2,22,13,9,4,2,2,11,2
31-12-2020 22:00:00,3,1,2,24,13,11,15,7,8,9,7
31-12-2020 23:00:00,0,0,0,12,7,5,0,0,0,5,4
